2.1.0	2.1.0	{Case: [genitive], Gender: [masculine], Number: [singular]}	
Orpheus	Orpheus	{Case: [genitive], Degree: [positive], Gender: [masculine], Number: [singular]}	
2.1.1	2.1.1	{Case: [genitive], Gender: [masculine], Number: [singular]}	
Ὀρφεὺς	Ὀρφεύς	{Case: [nominative], Gender: [masculine], Number: [singular]}	Orpheus
πάλαι·	πάλαι	{Case: [dative], Gender: [masculine], Number: [plural]}	long ago, in olden time, in days of yore, in time gone by
λύραν	λύρα	{Case: [accusative], Gender: [feminine], Number: [singular]}	lyre
χρυσῆν	χρυσή	{Case: [accusative], Gender: [feminine], Number: [singular]}	
δῶρον	δῶρον	{Case: [accusative], Gender: [neuter], Number: [singular]}	a gift, present
Ἀπόλλωνος·	Ἀπόλλων	{Case: [genitive], Gender: [masculine], Number: [singular]}	Apollo
Μοῦσαι	Μοῦσαι	{Case: [nominative], Gender: [masculine], Number: [plural]}	
ψάλλειν,	ψάλλω	{Tense: [present], VerbForm: [infinitive], Voice: [active]}	to touch sharply, to pluck, pull, twitch
ἐμπειρότατος	ἐμπείρος	{Case: [nominative], Degree: [superlative], Gender: [masculine], Number: [singular]}	
θέλγειν	ἐθέλγω	{Tense: [present], VerbForm: [infinitive], Voice: [active]}	
δένδρα	δένδρον	{Case: [nominative], Gender: [neuter], Number: [plural]}	a tree
μουσικῇ.	μουσικός	{Case: [dative], Degree: [positive], Gender: [feminine], Number: [singular]}	 musical, skilled in music, elegant
θῆρες,	θῆρυς	{Case: [nominative], Gender: [masculine], Number: [plural]}	
μέλος	μέλος	{Case: [accusative], Gender: [neuter], Number: [singular]}	a limb; a phrase of song; a song
Ὀρφεῖ	Ὀρφείς	{Case: [dative], Gender: [masculine], Number: [singular]}	
ἠκολούθουν.	ἀκολουθέω	{Aspect: [imperfective], Mood: [indicative], Number: [plural], Person: [third], Tense: [past], VerbForm: [finite], Voice: [active]}	to follow
2.1.2	ὅ.εις	{Case: [accusative], Gender: [masculine], Number: [singular], Person: [third], PrononimalType: [personal]}	
Ἐκεῖνος	Ἐκεῖνος	{Case: [nominative], Gender: [masculine], Number: [singular]}	
ξυνέσπετο	ξυμπίπτω	{Aspect: [imperfective], Mood: [indicative], Number: [singular], Person: [third], Tense: [past], VerbForm: [finite], Voice: [middle]}	
Ἰάσονι	Ἰάσων	{Case: [dative], Gender: [masculine], Number: [singular]}	Jason
Ἀργοναύταις,	Ἀργοναύτης	{Case: [dative], Gender: [masculine], Number: [plural]}	a sailor in the ship Argo, an Argonaut
εὐτυχήσαντες	εὐτυχέω	{Aspect: [perfective], Case: [nominative], Gender: [masculine], Number: [plural], Tense: [past], VerbForm: [participle], Voice: [active]}	to be well off, successful, prosperous
ἐστρατεύοντο	στρατεύω	{Aspect: [imperfective], Mood: [indicative], Number: [plural], Person: [third], Tense: [past], VerbForm: [finite], Voice: [middle]}	to serve in war, serve as a soldier, do military service, take the field, march
χρυσοῦν	χρύσεος	{Case: [accusative], Degree: [positive], Gender: [masculine], Number: [singular]}	golden, of gold, decked
πόκον	πόκος	{Case: [accusative], Gender: [masculine], Number: [singular]}	wool
κατῆλθον,	κατέρχομαι	{Aspect: [perfective], Mood: [indicative], Number: [plural], Person: [third], Tense: [past], VerbForm: [finite], Voice: [active]}	to go down from; return from exile
Θρᾴκῃ	Θρᾴκη	{Case: [dative], Gender: [feminine], Number: [singular]}	Thrace
κατῴκησεν.	κατοικέω	{Aspect: [perfective], Mood: [indicative], Number: [singular], Person: [third], Tense: [past], VerbForm: [finite], Voice: [active]}	to settle; to inhabit
ἔγημεν	γαμέω	{Aspect: [perfective], Mood: [indicative], Number: [singular], Person: [third], Tense: [past], VerbForm: [finite], Voice: [active]}	to marry
νύμφην	νύμφη	{Case: [accusative], Gender: [feminine], Number: [singular]}	a young wife, bride
Εὐρυδίκην·	Εὐρυδίκην	{Case: [accusative], Gender: [feminine], Number: [singular]}	
ἀλλ	ἀλλ	{}	
ὄφεως	ὄφις	{Case: [genitive], Gender: [masculine], Number: [singular]}	a serpent, snake
δηχθεῖσα	δηχόω	{Aspect: [perfective], Case: [nominative], Gender: [feminine], Number: [singular], Tense: [past], VerbForm: [participle], Voice: [passive]}	
βαρέως	βαρέως	{Degree: [positive]}	
ᾍδου	ὦδος	{Case: [genitive], Gender: [masculine], Number: [singular]}	
μετ	μετ	{Aspect: [perfective], Tense: [past], VerbForm: [infinitive], Voice: [active]}	
κατιέναι.	κατοναίνω	{Tense: [present], VerbForm: [infinitive], Voice: [active]}	
ἡδεά	ἡδέα	{Case: [accusative], Gender: [neuter], Number: [plural]}	
φωνήσας	φωνέω	{Aspect: [perfective], Case: [nominative], Gender: [masculine], Number: [singular], Tense: [past], VerbForm: [participle], Voice: [active]}	to produce a sound
μόλις	μόλις	{}	barely, scarcely
Πλούτωνα	Πλούτων	{Case: [accusative], Gender: [masculine], Number: [singular]}	Pluto
κάτω	κάτω	{Degree: [positive]}	down, downwards
Εὐρυδίκην	Εὐρυδίκη	{Case: [accusative], Gender: [feminine], Number: [singular]}	Eurydice
ἀπολύειν.	ἀπολύω	{Tense: [present], VerbForm: [infinitive], Voice: [active]}	to loose from
ὑπέσχετο	ὑπισχνέομαι	{Aspect: [perfective], Mood: [indicative], Number: [singular], Person: [third], Tense: [past], VerbForm: [finite], Voice: [middle]}	to promise
ἐφ	ἐφ	{}	
ᾧτε	ᾧτε	{}	
περιστρέφεσθαι	περιστρέφω	{Tense: [present], VerbForm: [infinitive], Voice: [middle]}	to whirl round
ἠφανίσθη.	ἀφανίζω	{Aspect: [perfective], Mood: [indicative], Number: [singular], Person: [third], Tense: [past], VerbForm: [finite], Voice: [passive]}	to make unseen, hide from sight
2.2.0	2.2.0	{Case: [genitive], Gender: [masculine], Number: [singular]}	
Leonidas	Leonidas	{Case: [genitive], Degree: [positive], Gender: [masculine], Number: [singular]}	
2.2.1	2.2.1	{}	
Λεωνίδας,	Λεωνίδαι	{Case: [accusative], Gender: [masculine], Number: [plural]}	
Λακεδαιμονίων	Λακεδαιμόνιος	{Case: [genitive], Degree: [positive], Gender: [masculine], Number: [plural]}	Spartan
βασιλεύς,	βασιλεύς,	{Case: [nominative], Gender: [masculine], Number: [singular]}	
ἀνδρειότατος	ἀνδρεῖος	{Case: [nominative], Degree: [superlative], Gender: [masculine], Number: [singular]}	of or for a man; courageous
ἀνθρώπων.	ἀνθρώπων	{Case: [genitive], Gender: [masculine], Number: [plural]}	
Πέρσας	Πέρσης	{Case: [accusative], Gender: [masculine], Number: [plural]}	a Persian; Perses (pr.n.)
Θερμοπύλαις,	Θερμοπύλαι	{Case: [dative], Gender: [feminine], Number: [plural]}	Thermopylae
τριακοσιόυς	τριακόσιος	{Case: [accusative], Degree: [positive], Gender: [masculine], Number: [plural]}	
ὁπλίτας,	ὁπλίτης	{Case: [accusative], Gender: [masculine], Number: [plural]}	heavy-armed, armed
μυριάδας	μυριάς	{Case: [accusative], Gender: [feminine], Number: [plural]}	a number of ten thousand, myriad
ἐχόντων.	χοντόν	{Case: [genitive], Gender: [masculine], Number: [plural], Tense: [present], VerbForm: [participle], Voice: [active]}	
παρεκέλευσε	παρακαλεύω	{Aspect: [perfective], Mood: [indicative], Number: [singular], Person: [third], Tense: [past], VerbForm: [finite], Voice: [active]}	
ἀθυμεῖν	ἀθυμέω	{Tense: [present], VerbForm: [infinitive], Voice: [active]}	to be disheartened, lose heart
ἀλλ	ἀλλῖς	{Case: [accusative], Gender: [masculine], Number: [singular], Person: [third], PrononimalType: [personal]}	
ἀνδρείως	ἀνδρείως	{Degree: [positive]}	
τέκνων.	τέκνων	{Case: [genitive], Gender: [neuter], Number: [plural]}	
Λεωνίδᾳ	Λεωνίδης	{Case: [dative], Gender: [masculine], Number: [singular]}	Leonidas
«Ἰδού,	«Ἰδού,	{Case: [genitive], Gender: [masculine], Number: [singular]}	
πλησίον	πλησίον	{}	
ἡμῶν	ἡμεῖς	{Case: [genitive], Gender: [masculine], Number: [plural], Person: [first], PrononimalType: [personal]}	
εἰσίν.»	οἶσαι	{Mood: [imperative], Number: [plural], Person: [second], Tense: [present], VerbForm: [finite], Voice: [active]}	
ταραχθείς,	ταράσσω	{Aspect: [perfective], Case: [nominative], Gender: [masculine], Number: [singular], Tense: [past], VerbForm: [participle], Voice: [passive]}	to stir, stir up, trouble
«Μᾶλλον	«Μᾶλλον	{Case: [accusative], Degree: [positive], Gender: [neuter], Number: [singular]}	
ἡσθείς	ἥδομαι	{Aspect: [perfective], Case: [nominative], Gender: [masculine], Number: [singular], Tense: [past], VerbForm: [participle], Voice: [passive]}	to enjoy oneself, take delight, take one's pleasure
,»	,»	{}	
ἀντεῖπεν,	ἀντιλέγω	{Aspect: [perfective], Mood: [indicative], Number: [singular], Person: [third], Tense: [past], VerbForm: [finite], Voice: [active]}	to speak against; speak in turn, reply
«καὶ	κκαί	{}	
πολεμίων.»	πολεμίων	{Case: [genitive], Degree: [positive], Gender: [masculine], Number: [plural]}	
2.3.0	2.3.0	{Case: [genitive], Gender: [masculine], Number: [singular]}	
Cleobis	Cleobis	{Case: [genitive], Degree: [positive], Gender: [masculine], Number: [singular]}	
and	and	{Case: [accusative], Gender: [feminine], Number: [singular]}	
Biton	Biton	{Case: [genitive], Gender: [masculine], Number: [singular]}	
2.3.1	2.3.1	{Case: [genitive], Gender: [masculine], Number: [singular]}	
Σόλων,	Σόλων	{Case: [nominative], Gender: [masculine], Number: [singular]}	Solon
Ἀθηναίων	Ἀθηναῖος	{Case: [genitive], Degree: [positive], Gender: [masculine], Number: [plural]}	Athenian, of Athens
νομοθέτης,	νομοθέτης,	{Case: [nominative], Gender: [masculine], Number: [singular]}	
Κλέοβιν	Κλέοβις	{Case: [accusative], Gender: [masculine], Number: [singular]}	
Βίτωνα	Βίτων	{Case: [accusative], Gender: [masculine], Number: [singular]}	Biton
ὀλβιωτάτους	ὄλβιος	{Case: [accusative], Degree: [superlative], Gender: [masculine], Number: [plural]}	happy, blest
ζῶντας,	ζῶ	{Case: [accusative], Gender: [masculine], Number: [plural], Tense: [present], VerbForm: [participle], Voice: [active]}	live
νεανιῶν	νεανίας	{Case: [genitive], Gender: [masculine], Number: [plural]}	young man
ἱέρεια	ἱέρειον	{Case: [nominative], Gender: [feminine], Number: [singular]}	
Ἥρας	Ἥρας	{Case: [genitive], Gender: [feminine], Number: [singular]}	
ἱεροῦ	ἱερόν	{Case: [genitive], Gender: [neuter], Number: [singular]}	sanctuary
Ἄργει·	Ἄργεις	{Case: [dative], Gender: [feminine], Number: [singular]}	
ἑορτῇ	ἑορτή	{Case: [dative], Gender: [feminine], Number: [singular]}	a feast
ἁμάξῃ.	ἁμάσ	{Aspect: [perfective], Mood: [subjunctive], Number: [singular], Person: [third], Tense: [past], VerbForm: [finite], Voice: [active]}	
Ξυνέβη	Ξυμαίνω	{Aspect: [perfective], Mood: [indicative], Number: [singular], Person: [third], Tense: [past], VerbForm: [finite], Voice: [active]}	
ἀγροῦ	ἀγρός	{Case: [genitive], Gender: [masculine], Number: [singular]}	fields, lands
παραγενέσθαι.	παραγίγνομαι	{Aspect: [perfective], Tense: [past], VerbForm: [infinitive], Voice: [middle]}	to come near, attend upon
νεανίαι,	νεανίης	{Case: [nominative], Gender: [masculine], Number: [plural]}	
μετέχειν	μετέχω	{Tense: [present], VerbForm: [infinitive], Voice: [active]}	to partake of, enjoy a share of, share in, take part in
ὑποδυσάμενοι	ὑποδύω	{Aspect: [perfective], Case: [nominative], Gender: [masculine], Number: [plural], Tense: [past], VerbForm: [participle], Voice: [middle]}	to put on under
ζυγὸν	ζυγόν	{Case: [accusative], Gender: [masculine], Number: [singular]}	yoke, pair
εἵλκυσαν	ἕλκω	{Aspect: [perfective], Mood: [indicative], Number: [plural], Person: [third], Tense: [past], VerbForm: [finite], Voice: [active]}	to draw, drag
ἅμαξαν	ἄμαξα	{Case: [accusative], Gender: [feminine], Number: [singular]}	a wagon
τεσσαράκοντα	τεσσαράκοντα	{}	forty
ἱερόν.	ἱερόνη	{Case: [accusative], Gender: [neuter], Number: [singular]}	
2.3.2	2.3.2	{Case: [genitive], Gender: [masculine], Number: [singular]}	
περιχαρὴς	περιχαρής	{Case: [nominative], Degree: [positive], Gender: [masculine], Number: [singular]}	exceeding joyous
ἔργῳ,	ἔργῳ,	{Case: [dative], Gender: [neuter], Number: [singular]}	
ηὔξατο	αὐξάνω	{Aspect: [perfective], Mood: [indicative], Number: [singular], Person: [third], Tense: [past], VerbForm: [finite], Voice: [middle]}	to make large, increase, augment
Ἥραν	Ἥρα	{Case: [accusative], Gender: [feminine], Number: [singular]}	Hera
δωρον	δωρον	{Case: [accusative], Gender: [neuter], Number: [singular]}	
εὐχήν,	εὐχήν	{Case: [accusative], Gender: [feminine], Number: [singular]}	
ἐδείπνησαν	δειπνέω	{Aspect: [perfective], Mood: [indicative], Number: [plural], Person: [third], Tense: [past], VerbForm: [finite], Voice: [active]}	to make a meal
νόμον.	νόμον	{Case: [accusative], Gender: [masculine], Number: [singular]}	
κατεκοιμήθησαν·	κατακοιμάω	{Aspect: [perfective], Mood: [indicative], Number: [plural], Person: [third], Tense: [past], VerbForm: [finite], Voice: [passive]}	to sleep through
οὔποτε	οὔποτε	{}	never
ἀνέστησαν,	ἀνίστημι	{Aspect: [perfective], Mood: [indicative], Number: [plural], Person: [third], Tense: [past], VerbForm: [finite], Voice: [active]}	to make to stand up, raise up
ὑπνοῦντες	ὑπνέω	{Case: [nominative], Gender: [masculine], Number: [plural], Tense: [present], VerbForm: [participle], Voice: [active]}	
ἡσύχως	ἡσύχως	{Degree: [positive]}	
θανεῖν,	θανέω	{Aspect: [perfective], Tense: [past], VerbForm: [infinitive], Voice: [active]}	
θεός,	θεός,	{Case: [nominative], Gender: [feminine], Number: [singular]}	
Κροίσῳ	Κροῖσος	{Case: [dative], Gender: [masculine], Number: [singular]}	Croesus
Κροῖσος,	Κροῖσος,	{Case: [nominative], Gender: [masculine], Number: [singular]}	
πλουσιώτατος	πλούσιος	{Case: [nominative], Degree: [superlative], Gender: [masculine], Number: [singular]}	rich, wealthy, opulent
ἤλπιζεν	ἐλπίζω	{Aspect: [imperfective], Mood: [indicative], Number: [singular], Person: [third], Tense: [past], VerbForm: [finite], Voice: [active]}	to hope for, look for, expect
2.4.0	2.4.0	{Case: [genitive], Gender: [masculine], Number: [singular]}	
Ajax	Ajax	{Case: [genitive], Gender: [masculine], Number: [singular]}	
Defends	Defends	{Case: [genitive], Gender: [masculine], Number: [singular]}	
the	the	{Case: [accusative], Gender: [feminine], Number: [singular]}	
Greek	Greek	{Case: [genitive], Gender: [masculine], Number: [singular]}	
Ships	Ships	{Case: [genitive], Degree: [positive], Gender: [masculine], Number: [singular]}	
2.4.1	2.4.1	{Case: [genitive], Gender: [masculine], Number: [singular]}	
Ἕκτωρ	Ἕκτωρ	{Case: [nominative], Gender: [masculine], Number: [singular]}	Hector
Τρώων	τρώς	{Case: [genitive], Gender: [masculine], Number: [plural]}	
Δαναοὺς	Δαναοί	{}	the Danaans
καταλύεσθαι	καταλύω	{Tense: [present], VerbForm: [infinitive], Voice: [middle]}	to put down, destroy; settle (disputes); lodge, rest
πόλεμον.	πόλεμον	{Case: [accusative], Gender: [masculine], Number: [singular]}	
Ἐξελθόντες	ἐξέρχομαι	{Aspect: [perfective], Case: [nominative], Gender: [masculine], Number: [plural], Tense: [past], VerbForm: [participle], Voice: [active]}	to go out, come out
ἐπορεύοντο	πορεύομαι	{Aspect: [imperfective], Mood: [indicative], Number: [plural], Person: [third], Tense: [past], VerbForm: [finite], Voice: [middle]}	
νῷ	νόος	{Case: [dative], Gender: [feminine], Number: [singular]}	mind, perception
προσβολὴν	προσβολή	{Case: [accusative], Gender: [feminine], Number: [singular]}	a putting to, application
Μάχη	Μάχη	{Case: [nominative], Gender: [feminine], Number: [singular]}	
καρτερὰ	καρτερός	{Case: [accusative], Degree: [positive], Gender: [feminine], Number: [singular]}	strong, staunch, stout, sturdy
Δαναῶν	Δαναᾶ	{Case: [genitive], Gender: [masculine], Number: [plural]}	
Ἀγαμέμνων	Ἀγαμέμνων	{Case: [nominative], Gender: [masculine], Number: [singular]}	Agamemnon, lit. the very steadfast
καθελκύσας	καθέλκω	{Aspect: [perfective], Case: [nominative], Gender: [masculine], Number: [singular], Tense: [past], VerbForm: [participle], Voice: [active]}	to draw
ἀνάγεσθαι,	ἀνάγω	{Tense: [present], VerbForm: [infinitive], Voice: [middle]}	to lead up; mid. set sail
Αἴας	Αἶα	{Case: [nominative], Gender: [masculine], Number: [singular]}	Aea (Colchis)
ξυγκαλέσας	ξυγκαλέω	{Aspect: [perfective], Case: [nominative], Gender: [masculine], Number: [singular], Tense: [past], VerbForm: [participle], Voice: [active]}	
Ἑλλήνων	Ἕλλην	{Case: [genitive], Gender: [masculine], Number: [plural]}	Hellen; Greek
ἀντεῖχε	ἀντέχω	{Aspect: [imperfective], Mood: [indicative], Number: [singular], Person: [third], Tense: [past], VerbForm: [finite], Voice: [active]}	to hold out against, withstand
2.4.3	2.4.3	{Case: [dative], Gender: [masculine], Number: [singular]}	
Αἴαντα	Αἴαντα	{Case: [accusative], Gender: [masculine], Number: [singular]}	
δόρατι	δόρυ	{Case: [dative], Gender: [neuter], Number: [singular]}	tree, plank, spear
ἔπληξε	πλήσσω	{Aspect: [perfective], Mood: [indicative], Number: [singular], Person: [third], Tense: [past], VerbForm: [finite], Voice: [active]}	to strike, smite
ἐτραυμάτισε	τραυματίζω	{Aspect: [perfective], Mood: [indicative], Number: [singular], Person: [third], Tense: [past], VerbForm: [finite], Voice: [active]}	to wound
οὔκ·	οὔκ	{}	
ζωστὴρ	ζωστός	{Case: [nominative], Degree: [positive], Gender: [masculine], Number: [singular]}	girded
ἤμυνε	ὄμνυμι	{Aspect: [imperfective], Mood: [indicative], Number: [singular], Person: [third], Tense: [past], VerbForm: [finite], Voice: [active]}	to swear
βέλος.	βέλος	{Case: [accusative], Gender: [neuter], Number: [singular]}	projectile; arrow, weapon
Ἕκτορα,	Ἕκτορα	{Case: [accusative], Gender: [masculine], Number: [singular]}	
ἑταίρους	ἑταῖρος	{Case: [accusative], Gender: [masculine], Number: [plural]}	a comrade, companion, mate
κατιόντα,	κάτειμι	{Case: [accusative], Gender: [masculine], Number: [singular], Tense: [present], VerbForm: [participle], Voice: [active]}	go down
αὐχένος,	αὐχήν	{Case: [genitive], Gender: [masculine], Number: [singular]}	the neck, throat
κατέπεσεν,	καταπίπτω	{Aspect: [perfective], Mood: [indicative], Number: [singular], Person: [third], Tense: [past], VerbForm: [finite], Voice: [active]}	to fall
σπεύδοντες	σπεύδω	{Case: [nominative], Gender: [masculine], Number: [plural], Tense: [present], VerbForm: [participle], Voice: [active]}	to set a-going, to urge on, hasten, quicken
συμμαχοι	συμμαχός	{Case: [nominative], Gender: [masculine], Number: [plural]}	
προίσταντο	προίστημι	{Aspect: [imperfective], Mood: [indicative], Number: [plural], Person: [third], Tense: [past], VerbForm: [finite], Voice: [middle]}	
ἀσπίσιν,	ἀσπίσις	{Case: [dative], Gender: [feminine], Number: [plural]}	
ἐξήνεγκαν	ἐκφέρω	{Aspect: [perfective], Mood: [indicative], Number: [plural], Person: [third], Tense: [past], VerbForm: [finite], Voice: [active]}	to carry out of
2.4.4	2.4.4	{Case: [genitive], Gender: [masculine], Number: [singular]}	
ἰάσατο	ἰάομαι	{Aspect: [perfective], Mood: [indicative], Number: [singular], Person: [third], Tense: [past], VerbForm: [finite], Voice: [middle]}	to heal, cure
τραῦμα,	τραῦμα	{Case: [accusative], Gender: [neuter], Number: [singular]}	a wound, hurt
αὖθις	αὖθις	{}	back, back again
μάχην.	μάχην	{Case: [accusative], Gender: [feminine], Number: [singular]}	
ἀμφότεροι	ἀμφότεροι	{Case: [nominative], Degree: [positive], Gender: [masculine], Number: [plural]}	
ξυνεμίγησαν,	ξυμμείγνυμι	{Aspect: [perfective], Mood: [indicative], Number: [plural], Person: [third], Tense: [past], VerbForm: [finite], Voice: [active]}	
ἔδρασάν	δράζω	{Aspect: [perfective], Mood: [indicative], Number: [plural], Person: [third], Tense: [past], VerbForm: [finite], Voice: [active]}	
ἁψάμενος	ἅπτω	{Aspect: [perfective], Case: [nominative], Gender: [masculine], Number: [singular], Tense: [past], VerbForm: [participle], Voice: [middle]}	to fasten, bind fast; set on fire; mid. touch
Πρωτεσιλάου	Πρωτεσίλαος	{Case: [genitive], Gender: [masculine], Number: [singular]}	Protesilaus, first-of-the-people
ἐπιβαίνειν	ἐπιβαίνω	{Tense: [present], VerbForm: [infinitive], Voice: [active]}	to go upon
ἐπειράσατο,	ἐπερίσταμαι	{Aspect: [perfective], Mood: [indicative], Number: [singular], Person: [third], Tense: [past], VerbForm: [finite], Voice: [middle]}	
ἀντέστησαν.	ἀνθίστημι	{Aspect: [perfective], Mood: [indicative], Number: [plural], Person: [third], Tense: [past], VerbForm: [finite], Voice: [active]}	to set against
Νυκτὸς	Νύκ	{Case: [genitive], Gender: [feminine], Number: [singular]}	
δ	δ	{Case: [genitive], Gender: [feminine], Number: [singular]}	
ἐπιγενομένης,	ἐπιγίγνομαι	{Aspect: [perfective], Case: [genitive], Gender: [feminine], Number: [singular], Tense: [past], VerbForm: [participle], Voice: [middle]}	to be born after, come into being after
ἰσόρροπος	ἰσόρροπος	{Case: [nominative], Gender: [masculine], Number: [singular]}	equally balanced, in equipoise
ἦν,	ἦν,	{}	
Τρῶες	Τρα	{Case: [nominative], Gender: [masculine], Number: [plural]}	
ἀνεχώρησαν.	ἀναχωρέω	{Aspect: [perfective], Mood: [indicative], Number: [plural], Person: [third], Tense: [past], VerbForm: [finite], Voice: [active]}	to go back
2.5.0	2.5.0	{Case: [genitive], Gender: [masculine], Number: [singular]}	
Alcestis	Alcestis	{Case: [genitive], Degree: [positive], Gender: [masculine], Number: [singular]}	
2.5.1	2.5.1	{Case: [genitive], Gender: [masculine], Number: [singular]}	
Ἄδμητος	Ἄδμης	{Case: [nominative], Gender: [masculine], Number: [singular]}	
Φεραίων.	Φεραῖων	{Case: [genitive], Degree: [positive], Gender: [masculine], Number: [plural]}	
Ὠφελήσας	Ὠφελέω	{Aspect: [perfective], Case: [nominative], Gender: [masculine], Number: [singular], Tense: [past], VerbForm: [participle], Voice: [active]}	
ἀπ	ἀπ	{}	
ἀντέτυχε	ἀντιτυγχάνω	{Aspect: [perfective], Mood: [indicative], Number: [singular], Person: [third], Tense: [past], VerbForm: [finite], Voice: [active]}	to meet with in return
ἀπαλλαγὴν	ἀπαλλαγή	{Case: [accusative], Gender: [feminine], Number: [singular]}	deliverance, release, relief from
ἐξευρεῖν	ἐξευρίσκω	{Aspect: [perfective], Tense: [past], VerbForm: [infinitive], Voice: [active]}	to find out, discover
ὑπερθανεῖν·	ὑπερθάνομαι	{Aspect: [perfective], Tense: [past], VerbForm: [infinitive], Voice: [active]}	
Ἄλκηστις	Ἄλκηστις	{Case: [nominative], Gender: [feminine], Number: [singular]}	Alcestis
2.5.2	2.5.2	{Case: [genitive], Gender: [masculine], Number: [singular]}	
Ἀφικόμενος	Ἀφικόμαιος	{Case: [nominative], Gender: [masculine], Number: [singular]}	
ἐκεῖσε	ἐκεῖσε	{}	thither, to that place
Ἡρακλῆς	Ἡρακλῆς	{Case: [genitive], Gender: [feminine], Number: [singular]}	Heracles
ἐπέτυχε	ἐπιτυγχάνω	{Aspect: [perfective], Mood: [indicative], Number: [singular], Person: [third], Tense: [past], VerbForm: [finite], Voice: [active]}	to hit the mark
Ἀδμήτῳ	Ἄδμητος	{Case: [dative], Gender: [masculine], Number: [singular]}	Admetus
δεινὰ	δεῖνα	{Case: [accusative], Degree: [positive], Gender: [neuter], Number: [plural]}	such an one, a certain one
2.5.3	2.5.3	{Case: [genitive], Gender: [masculine], Number: [singular]}	
Καταβὰς	καταβαίνω	{Aspect: [perfective], Case: [nominative], Gender: [masculine], Number: [singular], Tense: [past], VerbForm: [participle], Voice: [active]}	to step down, go
Θάνατον	Θάνατος	{Case: [accusative], Gender: [masculine], Number: [singular]}	
ἁμιλλησάμενος	ἁμιλλέω	{Aspect: [perfective], Case: [nominative], Gender: [masculine], Number: [singular], Tense: [past], VerbForm: [participle], Voice: [middle]}	
ἀνάγει	ἄνωγα	{Mood: [indicative], Number: [singular], Person: [third], Tense: [present], VerbForm: [finite], Voice: [active]}	to command, order
γῆν.	γῆνος	{Case: [accusative], Gender: [feminine], Number: [singular]}	
ἐκφαῖνει	ἐκφαίνω	{Mood: [indicative], Number: [singular], Person: [third], Tense: [present], VerbForm: [finite], Voice: [active]}	to shew forth, bring to light, disclose, reveal, make manifest
ἐστίν,	τίστημι	{Mood: [indicative], Number: [singular], Person: [third], Tense: [present], VerbForm: [finite], Voice: [active]}	
ἀμφικεκαλυμμένην	ἀμφικελύπτω	{Aspect: [perfective], Case: [accusative], Gender: [feminine], Number: [singular], Tense: [past], VerbForm: [participle], Voice: [passive]}	
θεραπεύειν	θεραπεύω	{Tense: [present], VerbForm: [infinitive], Voice: [active]}	to be an attendant, do service
μτινα	μτινα	{}	
αἱχμαλώτιδα.	αἱχμαλώτης	{Case: [accusative], Degree: [positive], Gender: [feminine], Number: [plural]}	
ἀναπείθεται·	ἀναπείθω	{Mood: [indicative], Number: [singular], Person: [third], Tense: [present], VerbForm: [finite], Voice: [middle]}	to bring over, convince
προελθοῦσα	προέρχομαι	{Aspect: [perfective], Case: [nominative], Gender: [feminine], Number: [singular], Tense: [past], VerbForm: [participle], Voice: [active]}	to go forward, go on, advance
2.6.0	2.6.0	{Case: [genitive], Gender: [masculine], Number: [singular]}	
The	The	{Case: [accusative], Gender: [feminine], Number: [singular]}	
Olympic	Olympic	{Case: [genitive], Gender: [feminine], Number: [singular]}	
Games	Games	{Case: [genitive], Degree: [positive], Gender: [masculine], Number: [singular]}	
2.6.1	2.6.1	{Case: [genitive], Gender: [masculine], Number: [singular]}	
Ἤλιδί	Ἤλις	{Case: [dative], Gender: [feminine], Number: [singular]}	
Ὀλυμπία,	Ὀλυμπία	{Case: [nominative], Gender: [feminine], Number: [singular]}	Olympia
πέμπτου	πέμπτος	{Case: [genitive], Gender: [neuter], Number: [singular]}	the fifth, oneself with four others
ἐγίγνοντο.	ἐγιγίγνομαι	{Aspect: [imperfective], Mood: [indicative], Number: [plural], Person: [third], Tense: [past], VerbForm: [finite], Voice: [middle]}	
ἁμίλλῃ	ἅμιλλα	{Case: [dative], Gender: [feminine], Number: [singular]}	a contest for superiority, a conflict
δρόμου	δρόμος	{Case: [genitive], Gender: [masculine], Number: [singular]}	a course, running, race
Ἴδης	Ἴδη	{Case: [genitive], Gender: [feminine], Number: [singular]}	Ida
Κρητικῆς	Κρητικός	{Case: [genitive], Degree: [positive], Gender: [feminine], Number: [singular]}	of Crete, Cretan
κλάδῳ	κλάδος	{Case: [dative], Gender: [masculine], Number: [singular]}	a young slip
κοτίνου	κότινος	{Case: [genitive], Degree: [positive], Gender: [masculine], Number: [singular]}	the wild olive-tree
στεφανώσειν·	στεφανόω	{Tense: [future], VerbForm: [infinitive], Voice: [active]}	to wreathe, to crown
ἆθλον	ἄθλος	{Case: [accusative], Gender: [neuter], Number: [singular]}	
ἀγῶσιν,	ἄγωσις	{Case: [dative], Gender: [masculine], Number: [plural]}	
στέφανος	στέφανος	{Case: [nominative], Gender: [masculine], Number: [singular]}	wreath, crown
κοτίνου.	κοτίνω	{Mood: [imperative], Number: [singular], Person: [third], Tense: [present], VerbForm: [finite], Voice: [middle]}	
Ὑπερβορέων	Ὑπερβορεύς	{Case: [genitive], Gender: [masculine], Number: [plural]}	
κότινόν	κότις	{Case: [accusative], Gender: [masculine], Number: [singular], PrononimalType: [relative]}	
Ἑλλάδα·	Ἑλλάς	{Case: [accusative], Gender: [feminine], Number: [singular]}	Hellas
Ὑπερβόρεοι	Ὑπερβόρεις	{Case: [nominative], Gender: [masculine], Number: [plural]}	
ἄνεμον	ἄνεμος	{Case: [accusative], Gender: [masculine], Number: [singular]}	wind
Βορεάν.	Βορεάν	{Case: [accusative], Gender: [masculine], Number: [singular]}	
2.6.2	2.6.2	{Case: [accusative], Gender: [masculine], Number: [singular]}	
ἀγώνων	ἄγων	{Case: [genitive], Gender: [masculine], Number: [plural]}	
προσέκειντο	πρόσκειμαι	{Aspect: [imperfective], Mood: [indicative], Number: [plural], Person: [third], Tense: [past], VerbForm: [finite], Voice: [middle]}	to be placed at, by; to be attached to, devoted to
πυγμὴ	πυγμή	{Case: [nominative], Gender: [feminine], Number: [singular]}	a fist
πάλη	πάλη	{Case: [nominative], Gender: [feminine], Number: [singular]}	wrestling
πήδημα.	πήδημα	{Case: [nominative], Gender: [neuter], Number: [singular]}	a leap, bound
ξυνελέγοντο	ξυναλέγω	{Aspect: [imperfective], Mood: [indicative], Number: [plural], Person: [third], Tense: [past], VerbForm: [finite], Voice: [middle]}	
θέαμα.	θέαμα	{Case: [accusative], Gender: [neuter], Number: [singular]}	that which is seen, a sight, show, spectacle
ἁρμάτων	ἅρμα	{Case: [genitive], Gender: [neuter], Number: [plural]}	a chariot
εἴχετο.	εἴχομαι	{Aspect: [imperfective], Mood: [indicative], Number: [singular], Person: [third], Tense: [past], VerbForm: [finite], Voice: [middle]}	
Ἀλκιβιάδης	Ἀλκιβιάδης	{Case: [nominative], Gender: [masculine], Number: [singular]}	Alcibiades
ἀλλ	ἀάπτω	{Mood: [indicative], Number: [singular], Person: [third], Tense: [present], VerbForm: [finite], Voice: [active]}	
Πλουσιώτατος	Πλουσιός	{Case: [nominative], Degree: [positive], Gender: [masculine], Number: [singular]}	
Ὀλύμπια	Ὀλύμπιος	{Case: [accusative], Degree: [positive], Gender: [neuter], Number: [plural]}	Olympian, of Olympus, dwelling on Olympus
2.6.3	2.6.3	{Case: [accusative], Degree: [positive], Gender: [masculine], Number: [singular]}	
ἀγωνιοῦσθαι,	ἀγωνιόομαι	{Tense: [present], VerbForm: [infinitive], Voice: [middle]}	
μῆνας	μείς	{Case: [accusative], Gender: [masculine], Number: [plural]}	a month; crescent moon
ἀσκεῖν	ἀσκέω	{Tense: [present], VerbForm: [infinitive], Voice: [active]}	(prose) exercise, train (poetry) to work curiously, form by art, fashion,  revere
γυμνάσιον	γυμνάσιον	{Case: [accusative], Gender: [neuter], Number: [singular]}	(gymnastic) school; (pl.) exercises
παλαίστραν	παλαίστρα	{Case: [accusative], Gender: [feminine], Number: [singular]}	a palaestra, wrestling-school
ἀπέχοντα	ἀπέχω	{Case: [accusative], Gender: [masculine], Number: [singular], Tense: [present], VerbForm: [participle], Voice: [active]}	to keep off
Διὸς	Ζεύς	{Case: [genitive], Gender: [masculine], Number: [singular]}	Zeus
ἄλσει	ἄλσος	{Case: [dative], Gender: [neuter], Number: [singular]}	a glade
πλατάνων	πλατάνω	{Case: [nominative], Gender: [masculine], Number: [singular], Tense: [present], VerbForm: [participle], Voice: [active]}	
ᾠκοδομημένῳ	οἰκοδομέω	{Aspect: [perfective], Case: [dative], Gender: [masculine], Number: [singular], Tense: [past], VerbForm: [participle], Voice: [passive]}	to build a house
εἰκόνας	εἰκών	{Case: [accusative], Gender: [feminine], Number: [plural]}	a likeness, image, portrait
ἀνέθηκαν	ἀνατίθημι	{Aspect: [perfective], Mood: [indicative], Number: [plural], Person: [third], Tense: [past], VerbForm: [finite], Voice: [active]}	dedicate, refer
ἄγαλμα	ἄγαλμα	{Case: [nominative], Gender: [neuter], Number: [singular]}	a glory, delight, honour; a cult statue
Φειδίας	Φειδίας	{Case: [genitive], Gender: [feminine], Number: [singular]}	Phidias
ἐλεφάντινον	ἐλεφάντινος	{Case: [nominative], Degree: [positive], Gender: [neuter], Number: [singular]}	of ivory, ivory
πεντήκοντα	πεντήκοντα	{}	fifty
ὕψος.	ὕψος	{Case: [nominative], Gender: [neuter], Number: [singular]}	height
Τουτο	τουτο	{}	
Βυζάντιον	Βυζάντιον	{Case: [accusative], Gender: [neuter], Number: [singular]}	Byzantium (no LSJ entry; see Byzantium)
2.7.0	2.7.0	{}	
Hector	Hector	{Case: [genitive], Degree: [positive], Gender: [feminine], Number: [singular]}	
Andromache	Andromache	{Case: [genitive], Degree: [positive], Gender: [masculine], Number: [singular]}	
2.7.1	2.7.1	{Case: [accusative], Gender: [masculine], Number: [singular]}	
Μακρὸν	Μάκροι	{Case: [accusative], Gender: [masculine], Number: [singular]}	
ἐπολιόρκουν	πολιορκέω	{Aspect: [imperfective], Mood: [indicative], Number: [plural], Person: [third], Tense: [past], VerbForm: [finite], Voice: [active]}	to hem in a city, blockade, beleaguer, besiege
Πάρις	Πάρις	{Case: [nominative], Gender: [feminine], Number: [singular]}	Paris son of Priam
Ἑλένην	Ἑλένη	{Case: [accusative], Gender: [feminine], Number: [singular]}	Helen
Μενέλεω	Μενέλαος	{Case: [genitive], Gender: [masculine], Number: [singular]}	Menelaos
Πάριδος.	Πάριδος	{Case: [genitive], Gender: [feminine], Number: [singular]}	
προσῆλθε	προσέρχομαι	{Aspect: [perfective], Mood: [indicative], Number: [singular], Person: [third], Tense: [past], VerbForm: [finite], Voice: [active]}	to come
«Εὖ	«Εὖ	{Case: [accusative], Gender: [neuter], Number: [singular], PrononimalType: [interrogative]}	
ὀργὴν	ὀργή	{Case: [accusative], Gender: [feminine], Number: [singular]}	natural impulse, mood, temperament; anger
καρδίᾳ	καρδία	{Case: [dative], Gender: [feminine], Number: [singular]}	the heart
οὕτω	οὕτω(ς)	{}	
διαμενῶ,	διαμένω	{Mood: [indicative], Number: [singular], Person: [first], Tense: [future], VerbForm: [finite], Voice: [active]}	to remain by, stand by
2.7.2	2.7.2	{Case: [genitive], Gender: [masculine], Number: [singular]}	
οἴκαδε	οἰκάω	{Aspect: [perfective], Mood: [indicative], Number: [singular], Person: [third], Tense: [past], VerbForm: [finite], Voice: [active]}	
ἀπῆλθεν,	ἀπέρχομαι	{Aspect: [perfective], Mood: [indicative], Number: [singular], Person: [third], Tense: [past], VerbForm: [finite], Voice: [active]}	to go away, depart from
Ἀνδρομάχην	Ἀνδρομάχη	{Case: [accusative], Gender: [feminine], Number: [singular]}	Andromache
τροφὸν	τροφός	{Case: [accusative], Gender: [feminine], Number: [singular]}	a feeder, rearer, nurse
κατιδοῦσα	καθοράω	{Aspect: [perfective], Case: [nominative], Gender: [feminine], Number: [singular], Tense: [past], VerbForm: [participle], Voice: [active]}	(to look down); to observe
ἀπῄτησεν	ἀποτίτημι	{Aspect: [perfective], Mood: [indicative], Number: [singular], Person: [third], Tense: [past], VerbForm: [finite], Voice: [active]}	
ἐξιέναι·	ξίνω	{Tense: [present], VerbForm: [infinitive], Voice: [active]}	
εἰ,	εἰ,	{}	
ἀποστήσεται	ἀφίστημι	{Mood: [indicative], Number: [singular], Person: [third], Tense: [future], VerbForm: [finite], Voice: [middle]}	to put away, remove; (mid.) revolt
2.7.3	2.7.3	{Case: [accusative], Gender: [masculine], Number: [singular]}	
φιλήσας	φιλέω	{Aspect: [perfective], Case: [nominative], Gender: [masculine], Number: [singular], Tense: [past], VerbForm: [participle], Voice: [active]}	to love, regard with affection
ἐπηύχετο	ἐπεύχομαι	{Aspect: [imperfective], Mood: [indicative], Number: [singular], Person: [third], Tense: [past], VerbForm: [finite], Voice: [middle]}	to pray
εὐκλεέστερον	εὔκλος	{Case: [accusative], Degree: [comparative], Gender: [neuter], Number: [singular]}	
ἔκλαυσεν.	κλαίω	{Aspect: [perfective], Mood: [indicative], Number: [singular], Person: [third], Tense: [past], VerbForm: [finite], Voice: [active]}	to weep, lament, wail
2.8.0	2.8.0	{Case: [genitive], Gender: [masculine], Number: [singular]}	
Socrates	Socrates	{Case: [genitive], Degree: [positive], Gender: [masculine], Number: [singular]}	
2.8.1	2.8.1	{Case: [genitive], Gender: [masculine], Number: [singular]}	
Σωκράτης,	Σωκράτης,	{Case: [nominative], Gender: [masculine], Number: [singular]}	
εὐπρεπὴς	εὐπρεπής	{Case: [nominative], Degree: [positive], Gender: [feminine], Number: [singular]}	well-looking, goodly, comely
ὦν,	οἶνα	{Aspect: [perfective], Mood: [indicative], Number: [singular], Person: [third], Tense: [past], VerbForm: [finite], Voice: [active]}	
ξυμπολῖται	ξυμπολίτης	{Case: [nominative], Gender: [masculine], Number: [plural]}	
2.8.2	2.8.2	{Case: [accusative], Degree: [positive], Gender: [masculine], Number: [plural]}	
Χαιρεφῶντι	Χαιρεφών	{Case: [dative], Gender: [masculine], Number: [singular]}	
ἀντεῖπεν	ἀντιρέω	{Aspect: [perfective], Mood: [indicative], Number: [singular], Person: [third], Tense: [past], VerbForm: [finite], Voice: [active]}	
Δελφοῖς	Δελφοί	{Case: [dative], Gender: [masculine], Number: [plural]}	Delphi; Delphians
Σωκράτους·	Σωκράτος	{Case: [accusative], Gender: [masculine], Number: [plural]}	
διαλέγεσθαι	διαλέγομαι	{Tense: [present], VerbForm: [infinitive], Voice: [middle]}	talk
ἐλέγξων	ἐλέγχω	{Case: [nominative], Gender: [masculine], Number: [singular], Tense: [present], VerbForm: [participle], Voice: [active]}	cross-examine; put to the test; prove; refute
μαντεῖον	μαντεῖον	{Case: [accusative], Gender: [neuter], Number: [singular]}	an oracle
ἀποφανῶν	ἀποφαίνω	{Case: [nominative], Gender: [masculine], Number: [singular], Tense: [present], VerbForm: [participle], Voice: [active]}	to shew fort, display, produce
σοφώτεροί	σοφώτεροι	{Case: [nominative], Degree: [comparative], Gender: [masculine], Number: [plural]}	
πειρασάμενος	πειράζω	{Aspect: [perfective], Case: [nominative], Gender: [masculine], Number: [singular], Tense: [past], VerbForm: [participle], Voice: [middle]}	to make proof
ἐλογίζετο,	λογίζομαι	{Aspect: [imperfective], Mood: [indicative], Number: [singular], Person: [third], Tense: [past], VerbForm: [finite], Voice: [middle]}	to count, reckon, calculate, compute
οἴονταί	φορέω	{Mood: [indicative], Number: [plural], Person: [third], Tense: [present], VerbForm: [finite], Voice: [middle]}	to bear
2.8.3	2.8.3	{Case: [nominative], Gender: [feminine], Number: [singular]}	
Ἀλλ	Ἀλλός	{Case: [nominative], Definiteness: [definite], Gender: [feminine], Number: [singular], PrononimalType: [demonstrative]}	
ἐξετάσεως	ἐξέτασις	{Case: [genitive], Gender: [feminine], Number: [singular]}	a close examination, scrutiny, review
ἀπέχθειαι	ἀπέχθεια	{Case: [nominative], Gender: [feminine], Number: [plural]}	hatred
διαβολαὶ	διαβολή	{Case: [nominative], Gender: [feminine], Number: [plural]}	false accusation, slander, calumny
Σωκράτει	Σωκράτης	{Case: [dative], Gender: [masculine], Number: [singular]}	Socrates
Ἀριστοφάνης	Ἀριστοφάνης	{Case: [nominative], Gender: [masculine], Number: [singular]}	Aristophanes
κατεγέλα	καταγίλνομαι	{Aspect: [perfective], Mood: [indicative], Number: [singular], Person: [third], Tense: [past], VerbForm: [finite], Voice: [active]}	
κωμῳδίαις,	κωμῳδία	{Case: [dative], Gender: [feminine], Number: [plural]}	a comedy
Μέλητός	Μέλη	{Case: [nominative], Gender: [masculine], Number: [singular]}	
Ἄνυτος	Ἄνυτος	{Case: [genitive], Gender: [masculine], Number: [singular]}	Anytus
Λύκων,	Λύκων	{Case: [genitive], Gender: [masculine], Number: [plural]}	Lycon
Μέλητος	Μέλητος	{Case: [nominative], Gender: [masculine], Number: [singular]}	Meletus
ἀχθόμενος	ἄχθομαι	{Case: [nominative], Gender: [masculine], Number: [singular], Tense: [present], VerbForm: [participle], Voice: [middle]}	to be loaded; to be annoyed
οὕσπερ	οὕσπερ	{}	
ἀγνοοῦντας,	ἀγνοέω	{Case: [accusative], Gender: [masculine], Number: [plural], Tense: [present], VerbForm: [participle], Voice: [active]}	not to perceive, be ignorant of
δημιουργῶν	δημιουργός	{Case: [genitive], Gender: [masculine], Number: [plural]}	one who works for the people, a skilled workman, handicraftsman
πολιτικῶν,	πολιτικός	{Case: [genitive], Degree: [positive], Gender: [masculine], Number: [plural]}	of, for, related to citizen or statesman; civil, constitutional
Λύκων	Λύκοι	{Case: [genitive], Gender: [masculine], Number: [plural]}	
ῥητόρων.	ῥητόρωνος	{Case: [genitive], Degree: [positive], Gender: [masculine], Number: [plural]}	
2.8.4	δι.άω	{Aspect: [perfective], Mood: [indicative], Number: [singular], Person: [third], Tense: [past], VerbForm: [finite], Voice: [active]}	
ἀντωμοσία	ἀντωμοσία	{Case: [nominative], Gender: [feminine], Number: [singular]}	an oath
δαιμόνια	δαιμόνιον	{Case: [accusative], Gender: [neuter], Number: [plural]}	divine being, spirit
καινά.	καινός	{Case: [accusative], Degree: [positive], Gender: [neuter], Number: [plural]}	new, fresh
Ἀλλ	ἀλλάω	{Aspect: [perfective], Mood: [indicative], Number: [singular], Person: [third], Tense: [past], VerbForm: [finite], Voice: [active]}	
ἀπολογούμενος	ἀπολογέομαι	{Case: [nominative], Gender: [masculine], Number: [singular], Tense: [present], VerbForm: [participle], Voice: [middle]}	to speak in defence, defend oneself
καίπερ	καίπερ	{}	although, albeit
ξυνετῶς	ξυνετῶς	{Degree: [positive]}	
καλῶς	καλῶς	{Degree: [positive]}	
δικαστάς,	δικαστάς	{Case: [accusative], Gender: [masculine], Number: [plural]}	
ὀφλῶν	ὀφλή	{Case: [genitive], Gender: [masculine], Number: [plural]}	
κατεκρίθη.	κατακρίνω	{Aspect: [perfective], Mood: [indicative], Number: [singular], Person: [third], Tense: [past], VerbForm: [finite], Voice: [passive]}	to give as sentence against
2.9.0	2.9.0	{Case: [genitive], Gender: [masculine], Number: [singular]}	
Prometheus	Prometheus	{Case: [genitive], Degree: [positive], Gender: [masculine], Number: [singular]}	
2.9.1	2.9.1	{Case: [genitive], Gender: [masculine], Number: [singular]}	
Προμηθέως,	προμηθέως	{}	
Αἰσχύλος	Αἰσχύλος	{Case: [nominative], Gender: [masculine], Number: [singular]}	Aeschylus
τοίαδε	τοίος	{Case: [accusative], Gender: [masculine], Number: [singular]}	
Κρόνου	Κρόνος	{Case: [genitive], Gender: [masculine], Number: [singular]}	Cronus
ἐπανέστη,	ἐπανίστημι	{Aspect: [perfective], Mood: [indicative], Number: [singular], Person: [third], Tense: [past], VerbForm: [finite], Voice: [active]}	to set up again
ἐξέβαλεν,	ἐκβάλλω	{Aspect: [perfective], Mood: [indicative], Number: [singular], Person: [third], Tense: [past], VerbForm: [finite], Voice: [active]}	to throw
ἡσυχίαν	ἡσυχία	{Case: [accusative], Gender: [feminine], Number: [singular]}	stillness, rest, quiet
Τιτᾶνες	Τιτᾶνες	{Case: [nominative], Gender: [masculine], Number: [plural]}	
2.9.2	2.9.2	{Case: [genitive], Gender: [masculine], Number: [singular]}	
Τέλος	Τέλος	{Case: [accusative], Gender: [neuter], Number: [singular]}	
ἐπικρατήσας	ἐπικρατέω	{Aspect: [perfective], Case: [nominative], Gender: [masculine], Number: [singular], Tense: [past], VerbForm: [participle], Voice: [active]}	to rule over
θεῶν.	θεῖν	{Case: [genitive], Gender: [masculine], Number: [plural]}	
Προμηθεὺς	προμέω	{Aspect: [perfective], Case: [nominative], Gender: [masculine], Number: [singular], Tense: [past], VerbForm: [participle], Voice: [passive]}	
Τιτὰν	Τιτάν	{Case: [accusative], Gender: [masculine], Number: [singular]}	Titan
ὤν,	ὤν,	{}	
προειδὼς	πρόοιδα	{Aspect: [perfective], Case: [nominative], Gender: [masculine], Number: [singular], Tense: [past], VerbForm: [participle], Voice: [active]}	to know beforehand
ἀμήχανον	ἀμήχανος	{Case: [accusative], Degree: [positive], Gender: [feminine], Number: [singular]}	without means
ἐσομένην,	εἰσίσκω	{Case: [accusative], Gender: [feminine], Number: [singular], Tense: [present], VerbForm: [participle], Voice: [middle]}	
παρῄνεσε	παρανίνω	{Aspect: [perfective], Mood: [indicative], Number: [singular], Person: [third], Tense: [past], VerbForm: [finite], Voice: [active]}	
Τιτᾶνας	Τιτών	{Case: [accusative], Gender: [masculine], Number: [plural]}	
ὑπείκειν,	ὑπείκω	{Tense: [present], VerbForm: [infinitive], Voice: [active]}	to retire, withdraw, depart
ἐξέπεσον.	ἐκπίπτω	{Aspect: [perfective], Mood: [indicative], Number: [plural], Person: [third], Tense: [past], VerbForm: [finite], Voice: [active]}	to fall out of
2.9.3	2.9.3	{Case: [accusative], Gender: [masculine], Number: [singular]}	
κράτος	κράτος	{Case: [accusative], Gender: [neuter], Number: [singular]}	strength, might
κακῶς	κακῶς	{Degree: [positive]}	
ἀντηγωνίζετο.	ἀντηγωνίζομαι	{Aspect: [imperfective], Mood: [indicative], Number: [singular], Person: [third], Tense: [past], VerbForm: [finite], Voice: [middle]}	
ὀργισθέντι	ὀργίζω	{Aspect: [perfective], Case: [dative], Gender: [masculine], Number: [singular], Tense: [past], VerbForm: [participle], Voice: [passive]}	to make angry, provoke to anger, irritate
τιμωρεῖσθαι	τιμωρέω	{Tense: [present], VerbForm: [infinitive], Voice: [middle]}	to seek, exact vengeance; help to retaliate
ἀγγέλους	ἄγγελος	{Case: [accusative], Gender: [masculine], Number: [plural]}	a messenger, envoy
Προμηθέα	Προμηθεύς	{Case: [accusative], Gender: [masculine], Number: [singular]}	Prometheus
ὑψηλόν	ὑψηλός	{Case: [accusative], Degree: [positive], Gender: [neuter], Number: [singular]}	high, lofty, high-raised
ἔρημον	ἔρημος	{Case: [accusative], Degree: [positive], Gender: [feminine], Number: [singular]}	
ἀπάγειν.	ἀπάγω	{Tense: [present], VerbForm: [infinitive], Voice: [active]}	to lead away, carry off
πέτρᾳ	πέτρα	{Case: [dative], Gender: [feminine], Number: [singular]}	a rock, a ledge
Καυκάσῳ	Καύκασος	{Case: [dative], Gender: [masculine], Number: [singular]}	Mt. Caucasus
προσηλώσαντες	προσηλόω	{Aspect: [perfective], Case: [nominative], Gender: [masculine], Number: [plural], Tense: [past], VerbForm: [participle], Voice: [active]}	to nail, pin
διάγειν	διάγω	{Tense: [present], VerbForm: [infinitive], Voice: [active]}	to carry over
ἠνάγκασαν	ἀναγκάζω	{Aspect: [perfective], Mood: [indicative], Number: [plural], Person: [third], Tense: [past], VerbForm: [finite], Voice: [active]}	to force, compel
ταλαιπωρίᾳ.	ταλαιπωρία	{Case: [dative], Gender: [feminine], Number: [singular]}	hard work, hardship, suffering, distress
2.9.4	2.9.4	{Case: [genitive], Degree: [positive], Gender: [masculine], Number: [singular]}	
ἀετὸν	ἀετός	{Case: [accusative], Gender: [masculine], Number: [singular]}	an eagle
ἔπεμψεν,	ἐπέμπ	{Aspect: [perfective], Mood: [indicative], Number: [singular], Person: [third], Tense: [past], VerbForm: [finite], Voice: [active]}	
ὅσπερ	ὅσπι	{Case: [nominative], Gender: [masculine], Number: [singular], PrononimalType: [relative]}	
ἐσπάρασσεν	σπαράσσω	{Aspect: [imperfective], Mood: [indicative], Number: [singular], Person: [third], Tense: [past], VerbForm: [finite], Voice: [active]}	to tear, rend in pieces, mangle
ἧπαρ,	ἧπαρή	{Case: [accusative], Gender: [neuter], Number: [singular]}	
ηὐξάνετο·	εὐξάνω	{Aspect: [imperfective], Mood: [indicative], Number: [singular], Person: [third], Tense: [past], VerbForm: [finite], Voice: [middle]}	
ὠφελήσειν	ὠφελέω	{Tense: [future], VerbForm: [infinitive], Voice: [active]}	to help, aid, assist, to be of use
ὑπακούειν.	ὑπακοιείνω	{Tense: [present], VerbForm: [infinitive], Voice: [active]}	
2.10.0	2.10.0	{Case: [genitive], Gender: [masculine], Number: [singular]}	
Death	Death	{Case: [genitive], Gender: [masculine], Number: [singular]}	
of	οἶ	{Aspect: [perfective], Mood: [imperative], Number: [singular], Person: [second], Tense: [past], VerbForm: [finite], Voice: [active]}	
2.10.1	2.10.1	{Case: [genitive], Gender: [masculine], Number: [singular]}	
Ἀχιλλεὺς	Ἀχιλλεύς	{Case: [nominative], Gender: [masculine], Number: [singular]}	Achilles
Δαναῶν,	Δαναῶνης	{Case: [genitive], Gender: [masculine], Number: [plural]}	
δι	δι	{}	
ἄστεως	ἄστι	{Case: [genitive], Gender: [neuter], Number: [singular]}	
πολιορκίας.	πολιορκία	{Case: [genitive], Gender: [feminine], Number: [singular]}	a besieging, siege
2.10.2	2.10.2	{Case: [genitive], Gender: [masculine], Number: [singular]}	
ἥρωες	ἥρως	{Case: [nominative], Gender: [masculine], Number: [plural]}	hero
ἀμφοτέρωθεν	ἀμφοτέρωθεν	{}	from both sides
Ἀχιλλεύς,	Ἀχιλλεύς,	{Case: [nominative], Gender: [masculine], Number: [singular]}	
εὐμενὴς	εὐμενής	{Case: [nominative], Degree: [positive], Gender: [masculine], Number: [singular]}	well-disposed, kindly
Τρῶσι,	τρῶσις	{Case: [dative], Gender: [masculine], Number: [plural]}	wounding
ἀποχωρεῖν	ἀποχωρέω	{Tense: [present], VerbForm: [infinitive], Voice: [active]}	to go from
πεδίῳ.	πεδίον	{Case: [dative], Gender: [neuter], Number: [singular]}	a plain
2.10.3	2.10.3	{Case: [genitive], Gender: [masculine], Number: [singular]}	
Πρίαμος,	Πρίαμος,	{Case: [nominative], Gender: [masculine], Number: [singular]}	
αὑτοῦ,	αὑτός	{Case: [genitive], Gender: [masculine], Number: [singular], Person: [third], PrononimalType: [personal]}	the same (crasis of ὁ αὐτός)
Ἑκάβη	Ἑκάβη	{Case: [nominative], Gender: [feminine], Number: [singular]}	Hecabe
δάκρυσιν	δάκρυον	{Case: [dative], Gender: [neuter], Number: [plural]}	a tear; tree sap, resin
ἀπῄτησαν	ἀπίτω	{Aspect: [perfective], Mood: [indicative], Number: [plural], Person: [third], Tense: [past], VerbForm: [finite], Voice: [active]}	
μηκέτι	μηκέτι	{Polarity: [neg]}	no more, no longer, no further
ἐσελθεῖν	εἰσέρχομαι	{Aspect: [perfective], Tense: [past], VerbForm: [infinitive], Voice: [active]}	to go in
διαμέλλειν,	διαμέλλω	{Tense: [present], VerbForm: [infinitive], Voice: [active]}	to be always going
ὑμῖν	ὑμεῖς	{Case: [dative], Gender: [masculine], Number: [plural], Person: [second], PrononimalType: [personal]}	ye, you
σφόδρα	σφόδρα	{}	very, very much, exceedingly, violently
ἐπιθυμῶ	ἐπιθυμέω	{Mood: [indicative], Number: [singular], Person: [first], Tense: [present], VerbForm: [finite], Voice: [active]}	to set one's heart upon
Ἀχιλλεῖ	Ἀχιλλῆς	{Case: [dative], Gender: [masculine], Number: [singular]}	
μονομαχεῖν	μονομαχέω	{Tense: [present], VerbForm: [infinitive], Voice: [active]}	to fight in single combat
ἀποφυγὼν	ἀποφεύγω	{Aspect: [perfective], Case: [nominative], Gender: [masculine], Number: [singular], Tense: [past], VerbForm: [participle], Voice: [active]}	to flee from, escape
ἐντὸς	ἐντός	{}	within, inside
πυλῶν	πυλή	{Case: [genitive], Gender: [masculine], Number: [plural]}	
2.10.4	2.10.4	{Case: [genitive], Gender: [masculine], Number: [singular]}	
ξυνεβοήθει	ξυνεβόω	{Mood: [indicative], Number: [singular], Person: [third], Tense: [present], VerbForm: [finite], Voice: [active]}	
Ἀθήνη	Ἀθῆναι	{Case: [nominative], Gender: [feminine], Number: [singular]}	the city of Athens
θάρσυνεν,	θαρσύω	{Aspect: [imperfective], Mood: [indicative], Number: [singular], Person: [third], Tense: [past], VerbForm: [finite], Voice: [active]}	
προσέβαλεν	προσβάλλω	{Aspect: [perfective], Mood: [indicative], Number: [singular], Person: [third], Tense: [past], VerbForm: [finite], Voice: [active]}	to strike
δόρατι,	δόρατις	{Case: [dative], Gender: [neuter], Number: [singular]}	
ὑποκύψας	ὑποκύπτω	{Aspect: [perfective], Case: [nominative], Gender: [masculine], Number: [singular], Tense: [past], VerbForm: [participle], Voice: [active]}	to stoop under a yoke
περιεγένετο.	περιγίγνομαι	{Aspect: [perfective], Mood: [indicative], Number: [singular], Person: [third], Tense: [past], VerbForm: [finite], Voice: [middle]}	to be superior to; to survive
λοιδορῶν	λοιδορέω	{Case: [nominative], Gender: [masculine], Number: [singular], Tense: [present], VerbForm: [participle], Voice: [active]}	to abuse, revile
ἀσπὶς	ἀσπίς	{Case: [nominative], Gender: [feminine], Number: [singular]}	a round shield; asp, Egyptian cobra
Ἀχιλλέως	Ἀχιλλέως	{Case: [genitive], Gender: [masculine], Number: [singular]}	
ἀπεκώλνοε	ἀποκωλνῴω	{Aspect: [imperfective], Mood: [indicative], Number: [singular], Person: [third], Tense: [past], VerbForm: [finite], Voice: [active]}	
ἠπόρει	ἀπορέω	{Aspect: [imperfective], Mood: [indicative], Number: [singular], Person: [third], Tense: [past], VerbForm: [finite], Voice: [active]}	[(Ion.) > ἀφοράω]
ξίφος	ξίφος	{Case: [accusative], Gender: [neuter], Number: [singular]}	a sword
σπάσας	σπάω	{Aspect: [perfective], Case: [nominative], Gender: [masculine], Number: [singular], Tense: [past], VerbForm: [participle], Voice: [active]}	to draw
ἐπετίθετο	ἐπιτίθημι	{Aspect: [imperfective], Mood: [indicative], Number: [singular], Person: [third], Tense: [past], VerbForm: [finite], Voice: [middle]}	to lay, put on; (mid.) to attack
Ἀχιλλεῖ,	Ἀχιλλεῖς	{Case: [dative], Gender: [masculine], Number: [singular]}	
λόγχῃ	λόγχη	{Case: [dative], Gender: [feminine], Number: [singular]}	a spear-head, javelin-head
2.10.5	2.10.5	{Case: [genitive], Gender: [masculine], Number: [singular]}	
φήμην	φήμη	{Case: [accusative], Gender: [feminine], Number: [singular]}	a voice from heaven, a prophetic voice
νεκρὸν	νεκρός	{Case: [accusative], Degree: [positive], Gender: [masculine], Number: [singular]}	a dead body, corpse
ἅρμοιτι	ἅρμος	{Case: [dative], Gender: [masculine], Number: [singular]}	
λιποψυχεῖ.	λιποψυχειόω	{Mood: [indicative], Number: [singular], Person: [third], Tense: [present], VerbForm: [finite], Voice: [active]}	
2.11.0	2.11.0	{Case: [genitive], Gender: [masculine], Number: [singular]}	
Battle	Battle	{Case: [genitive], Gender: [feminine], Number: [singular]}	
Plataea	Plataea	{Case: [genitive], Gender: [masculine], Number: [singular]}	
2.11.1	2.11.1	{Case: [genitive], Gender: [masculine], Number: [singular]}	
ἔπερσαν	περίζω	{Aspect: [perfective], Mood: [indicative], Number: [plural], Person: [third], Tense: [past], VerbForm: [finite], Voice: [active]}	
Σάρδεις,	Σάρδεις	{Case: [accusative], Gender: [feminine], Number: [plural]}	Sardes
Ἑλλάδα.	Ἑλλάδαι	{Case: [accusative], Gender: [feminine], Number: [singular]}	
Δαρεῖος	Δαρεῖος	{Case: [nominative], Gender: [masculine], Number: [singular]}	Darius
Μαραθῶνι	Μαραθών	{Case: [dative], Gender: [masculine], Number: [singular]}	Marathon
Ξέρξης	Ξέρξης	{Case: [nominative], Gender: [masculine], Number: [singular]}	Xerxes
ἀφράκτους	ἄφρακτος	{Case: [accusative], Degree: [positive], Gender: [masculine], Number: [plural]}	unfenced, unfortified, unguarded
Λεωνίδαν	Λεωνίδας	{Case: [accusative], Gender: [masculine], Number: [singular]}	
Σαλαμῖνι	Σαλαμίς	{Case: [dative], Gender: [feminine], Number: [singular]}	Salamis
ναυμαχήσαντες	ναυμαχέω	{Aspect: [perfective], Case: [nominative], Gender: [masculine], Number: [plural], Tense: [past], VerbForm: [participle], Voice: [active]}	to fight in a ship
ἡσσήθησαν.	ἡσσάομαι	{Aspect: [perfective], Mood: [indicative], Number: [plural], Person: [third], Tense: [past], VerbForm: [finite], Voice: [passive]}	to be less than another, inferior to
2.11.2	2.11.2	{Case: [genitive], Gender: [masculine], Number: [singular]}	
Μαρδόνιος	Μαρδόνιος	{Case: [nominative], Gender: [masculine], Number: [singular]}	Mardonius
πεζὸν	πεζός	{Case: [accusative], Degree: [positive], Gender: [masculine], Number: [singular]}	on foot
ἐνέτυχε	ἐντυγχάνω	{Aspect: [perfective], Mood: [indicative], Number: [singular], Person: [third], Tense: [past], VerbForm: [finite], Voice: [active]}	to light upon, fall in with, meet with
ξυμμάχοις	ξύμμαχος	{Case: [dative], Gender: [masculine], Number: [plural]}	
Πλαταιῶν.	Πλαταιενός	{Case: [genitive], Gender: [masculine], Number: [plural]}	
ἀντικαθέζονται,	ἀντικαθέζω	{Mood: [indicative], Number: [plural], Person: [third], Tense: [present], VerbForm: [finite], Voice: [middle]}	
οὐδέτερος	οὐδέτερος	{Case: [nominative], Gender: [masculine], Number: [singular]}	not either, neither of the two
φθάνειν·	φθάνω	{Tense: [present], VerbForm: [infinitive], Voice: [active]}	to come or do first, before others
δεξιὰ	δεξιός	{Case: [nominative], Degree: [positive], Gender: [neuter], Number: [plural]}	on the right; fortunate; dexterous, skillful, clever
θυμάτων	θαῦμα	{Case: [genitive], Gender: [neuter], Number: [plural]}	whatever one regards with wonder, a wonder, marvel
σημεῖα.	σημεῖα	{Case: [nominative], Gender: [neuter], Number: [plural]}	
2.11.3	2.11.3	{Case: [genitive], Degree: [positive], Gender: [neuter], Number: [singular]}	
στράτευμα	στράτευμα	{Case: [nominative], Gender: [neuter], Number: [singular]}	an expedition, campaign
ἐπιτήδεια·	ἐπιτήδειος	{Case: [nominative], Degree: [positive], Gender: [neuter], Number: [plural]}	suitable; useful, necessary; deserving; associate
ἀποπέμψαντες	ἀποπέμπω	{Aspect: [perfective], Case: [nominative], Gender: [masculine], Number: [plural], Tense: [past], VerbForm: [participle], Voice: [active]}	to send off
ἐσόδων.	ἐσόδων	{Case: [genitive], Gender: [feminine], Number: [plural]}	
χρονίζειν.	χρονίζω	{Tense: [present], VerbForm: [infinitive], Voice: [active]}	to spend time
2.11.4	2.11.4	{Case: [genitive], Gender: [masculine], Number: [singular]}	
Διατάξας	διατάσσω	{Aspect: [perfective], Case: [nominative], Gender: [masculine], Number: [singular], Tense: [past], VerbForm: [participle], Voice: [active]}	to appoint
προσεμίχθη.	προσμείγνυμι	{Aspect: [perfective], Mood: [indicative], Number: [singular], Person: [third], Tense: [past], VerbForm: [finite], Voice: [passive]}	to mingle
ἐπειδὴ	ἐπειδή	{}	
ἀντίπαλον	ἀντίπαλος	{Case: [accusative], Degree: [positive], Gender: [neuter], Number: [singular]}	wrestling against
πολεμῶν	πολεμός	{Case: [genitive], Gender: [masculine], Number: [plural]}	
ὅπερ	ὅπος	{Case: [accusative], Gender: [neuter], Number: [singular], PrononimalType: [relative]}	
φυγὴν	φυγή	{Case: [accusative], Gender: [feminine], Number: [singular]}	flight, exile
ξυμβοηθησάντων	ξυμβοέω	{Aspect: [perfective], Case: [genitive], Gender: [masculine], Number: [plural], Tense: [past], VerbForm: [participle], Voice: [active]}	
στρατόπεδον	στρατόπεδον	{Case: [accusative], Gender: [neuter], Number: [singular]}	the ground on which soldiers are encamped, a camp, encampment
ἔνδον	ἔνδον	{}	in, within, in the house, at home
σκῦλα	σκῦλον	{Case: [accusative], Gender: [neuter], Number: [plural]}	the arms stript off a slain enemy, spoils
τίμια	τίμιος	{Case: [accusative], Degree: [positive], Gender: [neuter], Number: [plural]}	valued
ἀνήρπασαν.	ἀναρπάζω	{Aspect: [perfective], Mood: [indicative], Number: [plural], Person: [third], Tense: [past], VerbForm: [finite], Voice: [active]}	to snatch up
2.12.0	2.12.0	{Case: [genitive], Gender: [masculine], Number: [singular]}	
Theseus	Theseus	{Case: [genitive], Degree: [positive], Gender: [masculine], Number: [singular]}	
2.12.1	2.12.1	{Case: [genitive], Gender: [masculine], Number: [singular]}	
Θησεύς,	Θησεύς,	{Case: [nominative], Gender: [masculine], Number: [singular]}	
παιδίον	παιδίον	{Case: [accusative], Gender: [neuter], Number: [singular]}	a child
ὢν,	ἀείνω	{Aspect: [perfective], Case: [nominative], Gender: [masculine], Number: [singular], Tense: [past], VerbForm: [participle], Voice: [active]}	
Τροιζῆνα	Τροιζήν	{Case: [accusative], Gender: [feminine], Number: [singular]}	Troezen
μητρός.	μήτρον	{Case: [genitive], Gender: [feminine], Number: [singular]}	
Αἰγεὺς	Αἰγεύς	{Case: [nominative], Gender: [masculine], Number: [singular]}	Aegeus
ἦρχεν.	ἀρχέω	{Aspect: [imperfective], Mood: [indicative], Number: [singular], Person: [third], Tense: [past], VerbForm: [finite], Voice: [active]}	
γάρ,	γάρ,	{}	
Αἰγέως	Αἴγεως	{Case: [genitive], Gender: [masculine], Number: [singular]}	
Θησέα	Θησεαί	{Case: [accusative], Gender: [masculine], Number: [singular]}	
ἱμάτιον.	ἱμάτιον	{Case: [accusative], Gender: [neuter], Number: [singular]}	an outer garment, a cloak
ὀρῶν	ὀρά	{Case: [genitive], Gender: [neuter], Number: [plural]}	
ἀγρίων	ἄγριος	{Case: [genitive], Degree: [positive], Gender: [masculine], Number: [plural]}	(living in the fields) wild, savage, harsh
θαλάσσαιν.	θαλάσσαινος	{Case: [dative], Gender: [feminine], Number: [plural]}	
γὸιρ	γός	{Case: [nominative], Gender: [masculine], Number: [plural]}	
κατῴκουν,	κατίκω	{Aspect: [imperfective], Mood: [indicative], Number: [plural], Person: [third], Tense: [past], VerbForm: [finite], Voice: [active]}	
ποίμνας	ποίμνη	{Case: [accusative], Gender: [feminine], Number: [plural]}	a flock
ἐσθίοντες	ἐσθίω	{Case: [nominative], Gender: [masculine], Number: [plural], Tense: [present], VerbForm: [participle], Voice: [active]}	to eat
2.12.2	2.12.2	{Case: [genitive], Gender: [masculine], Number: [singular]}	
Περιφήτῃ	Περιφήτης	{Case: [dative], Gender: [masculine], Number: [singular]}	
Ἡφαίστου	Ἠφαιστός	{Case: [genitive], Gender: [masculine], Number: [singular]}	
υἱῲ,	υἱίς	{Case: [dative], Gender: [masculine], Number: [singular]}	
ῥόπαλον	ῥόπαλον	{Case: [accusative], Gender: [neuter], Number: [singular]}	a club, cudgel
χαλκοῦν.	χαλκός	{Case: [accusative], Gender: [masculine], Number: [singular]}	copper
ῥοπάλῳ	ῥόπαλος	{Case: [dative], Gender: [masculine], Number: [singular]}	
πατάξας	πατάσσω	{Aspect: [perfective], Case: [nominative], Gender: [masculine], Number: [singular], Tense: [past], VerbForm: [participle], Voice: [active]}	to beat, knock
Θησεὺς	Θησεύς	{Case: [nominative], Gender: [masculine], Number: [singular]}	Theseus
ἀπορρίψας	ἀπορρίπτω	{Aspect: [perfective], Case: [nominative], Gender: [masculine], Number: [singular], Tense: [past], VerbForm: [participle], Voice: [active]}	to throw away, put away
προσέπεσε	προσπίπτω	{Aspect: [perfective], Mood: [indicative], Number: [singular], Person: [third], Tense: [past], VerbForm: [finite], Voice: [active]}	to fall upon, strike against
καί,	καί,	{Case: [dative], Gender: [masculine], Number: [singular]}	
κατέβαλεν	καταβάλλω	{Aspect: [perfective], Mood: [indicative], Number: [singular], Person: [third], Tense: [past], VerbForm: [finite], Voice: [active]}	to throw down, overthrow
προεπορεύθη.	προπορεύομαι	{Aspect: [perfective], Mood: [indicative], Number: [singular], Person: [third], Tense: [past], VerbForm: [finite], Voice: [passive]}	to go before
ἰσθμῷ	ἰσθμός	{Case: [dative], Gender: [masculine], Number: [singular]}	neck, narrow passage of land between seas
ηὗρε	αύρω	{Aspect: [perfective], Mood: [indicative], Number: [singular], Person: [third], Tense: [past], VerbForm: [finite], Voice: [active]}	
Σίνιν,	Σίνινα	{Case: [accusative], Gender: [masculine], Number: [singular]}	
ὠμῶς	ὠμῶς	{}	
ἀναιδῶς.	ἀναιδῶς.	{Degree: [positive]}	
2.12.3	2.12.3	{Case: [genitive], Gender: [masculine], Number: [singular]}	
Κατακάμψας	κατακάμπτω	{Aspect: [perfective], Case: [nominative], Gender: [masculine], Number: [singular], Tense: [past], VerbForm: [participle], Voice: [active]}	to bend down
πίτυε,	πίτυς	{Case: [accusative], Gender: [masculine], Number: [plural]}	the pine, stone pine
προσέδει	προσδέδομαι	{Aspect: [imperfective], Mood: [indicative], Number: [singular], Person: [third], Tense: [past], VerbForm: [finite], Voice: [active]}	
πιτύοιν,	πιτύω	{Mood: [optative], Number: [plural], Person: [third], Tense: [present], VerbForm: [finite], Voice: [active]}	
διέσπασεν.	διασπαίω	{Aspect: [perfective], Mood: [indicative], Number: [singular], Person: [third], Tense: [past], VerbForm: [finite], Voice: [active]}	
δεινῶς	δεινῶς	{Degree: [positive]}	
ἠγωνίζοντο,	ἀγωνίζομαι	{Case: [genitive], Gender: [masculine], Number: [singular], Tense: [present], VerbForm: [participle], Voice: [active]}	to contend for a prize
ὁμοίως	ὁμοίως	{}	similarly
κρεμασθὲν	κρεμάννυμι	{Aspect: [perfective], Case: [accusative], Gender: [neuter], Number: [singular], Tense: [past], VerbForm: [participle], Voice: [passive]}	to hang, hang up
διετέλει	διατελέω	{Aspect: [imperfective], Mood: [indicative], Number: [singular], Person: [third], Tense: [past], VerbForm: [finite], Voice: [active]}	(w. pple.) continually...; to bring quite to an end, accomplish
Ἀθηνῶν.	Ἀθῆνανος	{Case: [genitive], Gender: [feminine], Number: [plural]}	
ἅρπαγα	ἅρπαξ	{Case: [accusative], Degree: [positive], Gender: [masculine], Number: [singular]}	(m) robber, grappling-iron; (f) robbing, grabbing
Σκίρωνα	Σκίρων	{Case: [accusative], Gender: [masculine], Number: [singular]}	Sciron, a north-west wind; a mythical robber
ἀπῶσεν	ἀπόω	{Aspect: [perfective], Mood: [indicative], Number: [singular], Person: [third], Tense: [past], VerbForm: [finite], Voice: [active]}	
θάλασσαν.	θάλασσαν	{Case: [accusative], Gender: [feminine], Number: [singular]}	
πέτρος	πέτρος	{Case: [nominative], Gender: [masculine], Number: [singular]}	a stone
Κερκυόνα	Κερκύων	{Case: [accusative], Gender: [feminine], Number: [singular]}	Cercyon
Ἐλευσῖνι	Ἐλευσίς	{Case: [dative], Gender: [feminine], Number: [singular]}	Eleusis, an old city of Attica
Προκρούστην	Προκροῦστης	{Case: [accusative], Gender: [masculine], Number: [singular]}	
λῃστήν,	λῃστής	{Case: [accusative], Gender: [masculine], Number: [singular]}	a robber, plunderer
Φαῖαν	Φαῖα	{Case: [accusative], Gender: [feminine], Number: [singular]}	
ὗν	ὗς	{Case: [accusative], Gender: [feminine], Number: [singular]}	wild swine
ἐπόρθει.	πορθέω	{Aspect: [imperfective], Mood: [indicative], Number: [singular], Person: [third], Tense: [past], VerbForm: [finite], Voice: [active]}	to destroy, ravage, waste, plunder
2.13.0	2.13.0	{Case: [genitive], Gender: [masculine], Number: [singular]}	
Iphigenia	Iphigenia	{Case: [genitive], Degree: [positive], Gender: [masculine], Number: [singular]}	
2.13.1	2.13.1	{Case: [genitive], Gender: [masculine], Number: [singular]}	
μῦθοι	μῦθος	{Case: [nominative], Gender: [masculine], Number: [plural]}	anything, delivered by word of mouth, word, speech
Τρωικά.	Τρωικεύς	{Case: [accusative], Degree: [positive], Gender: [neuter], Number: [plural]}	
ἔτη.	τημί	{Aspect: [perfective], Mood: [indicative], Number: [singular], Person: [third], Tense: [past], VerbForm: [finite], Voice: [active]}	
ἀπιέναι,	ἄπειμι	{Tense: [present], VerbForm: [infinitive], Voice: [active]}	be absent
ἐξῆν	ἔξεστι	{Aspect: [imperfective], Mood: [indicative], Number: [singular], Person: [third], Tense: [past], VerbForm: [finite], Voice: [active]}	it is allowed, it is in one's power, is possible
ἀπορίᾳ	ἀπορία	{Case: [dative], Gender: [feminine], Number: [singular]}	difficulty of passing
ἀποπλεῦσαι.	ἀποπλέω	{Aspect: [perfective], Tense: [past], VerbForm: [infinitive], Voice: [active]}	to sail away, sail off
2.13.2	2.13.2	{Case: [genitive], Gender: [masculine], Number: [singular]}	
Κάλχας	Κάλχας	{Case: [nominative], Gender: [masculine], Number: [singular]}	Calchas
μάντις	μάντις	{Case: [nominative], Gender: [masculine], Number: [singular]}	one who divines, a seer, prophet
Ἄρτεμις	Ἄρτεμις	{Case: [nominative], Gender: [feminine], Number: [singular]}	Artemis
ἄλσει,	ἄλσις	{Case: [dative], Gender: [neuter], Number: [singular]}	growth
ναυτικὸν	ναυτικός	{Case: [nominative], Degree: [positive], Gender: [neuter], Number: [singular]}	seafaring, naval
Παραινεῖ	παραινέω	{Mood: [indicative], Number: [singular], Person: [third], Tense: [present], VerbForm: [finite], Voice: [active]}	to exhort, recommend, advise
Ἰφιγένειαν	Ἰφιγένεια	{Case: [accusative], Gender: [feminine], Number: [singular]}	strong-born
καταπραϋνοῦντι.	καταπραϋνουντίζω	{Case: [dative], Gender: [masculine], Number: [singular], Tense: [present], VerbForm: [participle], Voice: [active]}	
2.13.3	2.13.3	{Case: [genitive], Gender: [masculine], Number: [singular]}	
ἀντεισαγαγοῦσα	ἀντισαγάγνυμι	{Aspect: [perfective], Case: [nominative], Gender: [feminine], Number: [singular], Tense: [past], VerbForm: [participle], Voice: [active]}	
ἔλαφον	ἔλαφον	{Case: [accusative], Gender: [masculine], Number: [singular]}	
Ἰφιγενείας	Ἰφιγενεία	{Case: [genitive], Gender: [feminine], Number: [singular]}	
ἀπενεγκεῖν	ἀποφέρω	{Aspect: [perfective], Tense: [past], VerbForm: [infinitive], Voice: [active]}	to carry off
Ταυρικήν,	Ταυρικός	{Case: [accusative], Degree: [positive], Gender: [feminine], Number: [singular]}	
διέσωσεν	διασῴζω	{Aspect: [perfective], Mood: [indicative], Number: [singular], Person: [third], Tense: [past], VerbForm: [finite], Voice: [active]}	to preserve through
Ὀρέστην	Ὀρέστης	{Case: [accusative], Gender: [masculine], Number: [singular]}	Orestes; pl., the Orestae, an Epirot people
Ἀρτέμιδι,	Ἀρτέμιδις	{Case: [dative], Gender: [feminine], Number: [singular]}	
2.14.0	2.14.0	{Case: [genitive], Gender: [masculine], Number: [singular]}	
Daedalus	Daedalus	{Case: [genitive], Degree: [positive], Gender: [masculine], Number: [singular]}	
Pasiphae	Pasiphae	{Case: [genitive], Degree: [positive], Gender: [masculine], Number: [singular]}	
2.14.1	2.14.1	{Case: [genitive], Gender: [masculine], Number: [singular]}	
Δαίδαλος	Δαίδαλος	{Case: [nominative], Gender: [masculine], Number: [singular]}	Daedalus
ἀξίνην·	ἀξίνην	{Case: [accusative], Gender: [feminine], Number: [singular]}	
δεξιῶς	δεξιῶς	{Degree: [positive]}	
δέ,	δέ,	{}	
ἀδελφιδοῦν	ἀδελφιδή	{Case: [accusative], Gender: [masculine], Number: [singular]}	
Τᾶλον,	Ταλός	{Case: [accusative], Gender: [masculine], Number: [singular]}	
Ἐφθόνησε	φθονέω	{Aspect: [perfective], Mood: [indicative], Number: [singular], Person: [third], Tense: [past], VerbForm: [finite], Voice: [active]}	to bear ill-will
Τάλῳ	Τάλος	{Case: [dative], Gender: [masculine], Number: [singular]}	
δεινότητος,	δεινότης	{Case: [genitive], Gender: [feminine], Number: [singular]}	terribleness
τεχνῶν,	τεχνών	{Case: [genitive], Gender: [masculine], Number: [plural]}	
πρίονα,	πρίον	{Case: [accusative], Gender: [masculine], Number: [singular]}	
μιμούμενος	μιμέομαι	{Case: [nominative], Gender: [masculine], Number: [singular], Tense: [present], VerbForm: [participle], Voice: [middle]}	to mimic, imitate, represent, portray
ἰχθύος	ἰχθύς	{Case: [genitive], Gender: [masculine], Number: [singular]}	a fish
ῥάχιν,	ῥάχις	{Case: [accusative], Gender: [feminine], Number: [singular]}	the lower part of the back, the chine
τροχὸν	τροχός	{Case: [accusative], Gender: [masculine], Number: [singular]}	wheel
χρώμενος	χράω	{Case: [nominative], Gender: [masculine], Number: [singular], Tense: [present], VerbForm: [participle], Voice: [middle]}	to fall upon, attack, assail
κεραμεὺς	κεραμεύς	{Case: [nominative], Gender: [masculine], Number: [singular]}	a potter
πλάσσει	πλάσσω	{Mood: [indicative], Number: [singular], Person: [third], Tense: [present], VerbForm: [finite], Voice: [active]}	to form, mould, shape
Κρήτην,	Κρήτην	{Case: [accusative], Gender: [feminine], Number: [singular]}	
μεσημβρίαν	μεσημβρία	{Case: [accusative], Gender: [feminine], Number: [singular]}	mid-day, noon; south
Μίνως	Μίνως	{Case: [nominative], Gender: [masculine], Number: [singular]}	Minos
2.14.2	2.14.2	{Case: [genitive], Gender: [masculine], Number: [singular]}	
λαβύρινθον.	λαβύρινθον	{Case: [accusative], Gender: [masculine], Number: [singular]}	
ἀγανακτήσας	ἀγανακτέω	{Aspect: [perfective], Case: [nominative], Gender: [masculine], Number: [singular], Tense: [past], VerbForm: [participle], Voice: [active]}	to feel irritation
Ἴκαρον	Ἴκαρος	{Case: [accusative], Gender: [masculine], Number: [singular]}	Icarus
λαβυρίνθῳ.	λαβυρίνθον	{Case: [dative], Gender: [masculine], Number: [singular]}	
Πασιφάη	Πασιφάη	{Case: [nominative], Gender: [feminine], Number: [singular]}	Pasiphae
φιλικῶς	φιλικῶς	{Degree: [positive]}	
ἐζημίωσεν	ζημιόω	{Aspect: [perfective], Mood: [indicative], Number: [singular], Person: [third], Tense: [past], VerbForm: [finite], Voice: [active]}	cause a loss, penalize; fine; punish
πτερὰ	πτερός	{Case: [accusative], Degree: [positive], Gender: [neuter], Number: [plural]}	
κηροῦ	κηρός	{Case: [genitive], Gender: [masculine], Number: [singular]}	bees-wax
ἀνέπταντο.	ἀναπτάομαι	{Mood: [indicative], Number: [plural], Person: [third], Tense: [pluperfect], VerbForm: [finite], Voice: [middle]}	
κατετάκη,	κατατάσσω	{Aspect: [perfective], Mood: [indicative], Number: [singular], Person: [third], Tense: [past], VerbForm: [finite], Voice: [passive]}	to draw up in order, arrange
ἐπνίγη.	ἐπνίγνυμι	{Aspect: [perfective], Mood: [indicative], Number: [singular], Person: [third], Tense: [past], VerbForm: [finite], Voice: [passive]}	
πόντος	πόνς	{Case: [genitive], Gender: [masculine], Number: [singular]}	
Ἰκάριος	Ἰκάριος	{Case: [nominative], Degree: [positive], Gender: [masculine], Number: [singular]}	Icarian
Ἑλλήνων.	Ἑλλήνων	{Case: [genitive], Gender: [masculine], Number: [plural]}	
Ἰταλίαν	Ἰταλία	{Case: [accusative], Gender: [feminine], Number: [singular]}	Italy
ἀσφαλής,	ἀσφαλής	{Case: [nominative], Degree: [positive], Gender: [masculine], Number: [singular]}	not liable to fall, immoveable, steadfast, firm
Σικελίαν	Σικελία	{Case: [accusative], Gender: [feminine], Number: [singular]}	Sicily
παρῆλθεν.	παρέρχομαι	{Aspect: [perfective], Mood: [indicative], Number: [singular], Person: [third], Tense: [past], VerbForm: [finite], Voice: [active]}	to go by, beside
2.14.3	2.14.3	{Case: [genitive], Gender: [masculine], Number: [singular]}	
Μίνω,	Μίνω,	{Case: [genitive], Gender: [masculine], Number: [singular]}	
οἶκον.	οἰκονή	{Case: [accusative], Gender: [masculine], Number: [singular]}	
Μίνων,	Μίνων	{Case: [accusative], Gender: [masculine], Number: [singular]}	
βιώσας,	βιάω	{Aspect: [perfective], Case: [nominative], Gender: [masculine], Number: [singular], Tense: [past], VerbForm: [participle], Voice: [active]}	to constrain
ὑποδοχὴν	ὑποδοχή	{Case: [accusative], Gender: [feminine], Number: [singular]}	a reception, entertainment
κατήχθη,	κατήγω	{Aspect: [perfective], Mood: [indicative], Number: [singular], Person: [third], Tense: [past], VerbForm: [finite], Voice: [passive]}	
2.15.0	2.15.0	{Case: [genitive], Gender: [masculine], Number: [singular]}	
Hercules	Hercules	{Case: [genitive], Degree: [positive], Gender: [masculine], Number: [singular]}	
Amazons	Amazons	{Case: [genitive], Degree: [positive], Gender: [masculine], Number: [singular]}	
2.15.1	2.15.1	{Case: [genitive], Gender: [feminine], Number: [singular]}	
κλεινότατος	κλείνως	{Case: [nominative], Degree: [superlative], Gender: [masculine], Number: [singular]}	
Ἀλκμήνης,	Ἀλκμήνη	{Case: [nominative], Gender: [masculine], Number: [singular]}	Alcmene
ἔμπειρος	ἔμπειρος	{Case: [nominative], Degree: [positive], Gender: [masculine], Number: [singular]}	experienced
τοξεύειν	τοξεύω	{Tense: [present], VerbForm: [infinitive], Voice: [active]}	to shoot with the bow
ᾄδειν.	ἀδείνω	{Tense: [present], VerbForm: [infinitive], Voice: [active]}	
Φυλάσσων	Φυλάσσων	{Case: [genitive], Degree: [positive], Gender: [masculine], Number: [plural]}	
θαυμαστόν	θαυμαστός	{Case: [accusative], Degree: [positive], Gender: [neuter], Number: [singular]}	wondrous, wonderful, marvellous
Λέων	Λέων	{Case: [nominative], Gender: [masculine], Number: [singular]}	Leon
Κιθαιρῶνος	Κιθαιρών	{Case: [genitive], Gender: [masculine], Number: [singular]}	Mount Cithaeron
ἔτεμνεν·	τεμνέω	{Aspect: [imperfective], Mood: [indicative], Number: [singular], Person: [third], Tense: [past], VerbForm: [finite], Voice: [active]}	
δέρμα	δέρμα	{Case: [accusative], Gender: [neuter], Number: [singular]}	the skin, hide
εἶχεν.	οἶχα	{Aspect: [imperfective], Mood: [indicative], Number: [singular], Person: [third], Tense: [past], VerbForm: [finite], Voice: [active]}	
Πυθία	Πυθία	{Case: [nominative], Gender: [feminine], Number: [singular]}	the Pythia, priestess of Pythian Apollo
ἐπέταξεν	ἐπιτάσσω	{Aspect: [perfective], Mood: [indicative], Number: [singular], Person: [third], Tense: [past], VerbForm: [finite], Voice: [active]}	to put upon one as a duty, to enjoin
δουλεύειν	δουλεύω	{Tense: [present], VerbForm: [infinitive], Voice: [active]}	to be a slave
Εὐρυσθεῖ	Εὐρυσθεύς	{}	Eurystheus
δώδεκα	δώδεκα	{}	twelve
διέπραξε	διαπράσσω	{Aspect: [perfective], Mood: [indicative], Number: [singular], Person: [third], Tense: [past], VerbForm: [finite], Voice: [active]}	to pass over; bring about, accomplish
ἔργα.	ἔργα	{Case: [accusative], Gender: [neuter], Number: [plural]}	
2.15.2	2.15.2	{Case: [genitive], Degree: [positive], Gender: [masculine], Number: [singular]}	
Ἀμαζόνες	Ἀμαζών	{Case: [nominative], Gender: [masculine], Number: [plural]}	the Amazons
μαχιμωτάτων·	μαχιμός	{Case: [genitive], Degree: [superlative], Gender: [masculine], Number: [plural]}	
βασίλεια	βασίλεια	{Case: [nominative], Gender: [feminine], Number: [singular]}	a queen, princess
Ἱππολύτη·	Ἱππολύτη·	{Case: [nominative], Gender: [masculine], Number: [singular]}	
ζώνην	ζώνη	{Case: [accusative], Gender: [feminine], Number: [singular]}	a belt, girdle
Ἄρεος	Ἄρης	{Case: [genitive], Gender: [masculine], Number: [singular]}	Ares
πολέμου.	πολέμους	{Case: [genitive], Gender: [masculine], Number: [singular]}	
ἀνακομίσαι.	ἀνακομίζω	{Aspect: [perfective], Tense: [past], VerbForm: [infinitive], Voice: [active]}	to carry up
Ἱππολύτη	Ἱππολύτη	{Case: [nominative], Gender: [feminine], Number: [singular]}	
ἐπεγειράσης	ἐπιγείρω	{Aspect: [perfective], Case: [genitive], Gender: [feminine], Number: [singular], Tense: [past], VerbForm: [participle], Voice: [active]}	
ἐπ	ἐπ	{}	
ζώνην.	ζώνην	{Case: [accusative], Gender: [feminine], Number: [singular]}	
2.15.3	2.15.3	{Case: [genitive], Gender: [masculine], Number: [singular]}	
βασιλεύοντος	βασιλεύω	{Case: [genitive], Gender: [masculine], Number: [singular], Tense: [present], VerbForm: [participle], Voice: [active]}	to be king, to rule, reign
ἐσβολὴν	εἰσβολή	{Case: [accusative], Gender: [feminine], Number: [singular]}	an inroad, invasion, attack
Ἀττικήν.	Ἀττικήν	{Case: [accusative], Degree: [positive], Gender: [feminine], Number: [singular]}	
Τρωικοῖς	Τρωικός	{Case: [dative], Degree: [positive], Gender: [masculine], Number: [plural]}	
Πριάμῳ	Πρίαμος	{Case: [dative], Gender: [masculine], Number: [singular]}	Priam
Πενθεσίλειαν	Πενθεσίλεια	{Case: [accusative], Gender: [feminine], Number: [singular]}	
2.16.0	2.16.0	{Case: [genitive], Gender: [masculine], Number: [singular]}	
Orestes	Orestes	{Case: [nominative], Degree: [positive], Gender: [masculine], Number: [singular]}	
2.16.1	2.16.1	{Case: [nominative], Gender: [masculine], Number: [singular]}	
δή,	δή,	{Case: [nominative], Gender: [masculine], Number: [singular]}	
Ὀρέστου,	Ὀρέστος	{Case: [genitive], Gender: [masculine], Number: [singular]}	
ἀντῆν	αντάω	{Aspect: [perfective], Mood: [indicative], Number: [singular], Person: [third], Tense: [past], VerbForm: [finite], Voice: [active]}	
ἅτε	ἅτε	{}	just as (both pre-and postposed); w. part.: because
Τρῶας.	Τρῶας	{Case: [accusative], Gender: [masculine], Number: [plural]}	
Αἰγίσθου	Αἴγισθος	{Case: [genitive], Gender: [masculine], Number: [singular]}	Aegisthus
ἐπιβουλεύσασα	ἐπιβουλεύω	{Aspect: [perfective], Case: [nominative], Gender: [feminine], Number: [singular], Tense: [past], VerbForm: [participle], Voice: [active]}	to plot against
ἐγήματο.	ἔγημα	{Case: [genitive], Gender: [neuter], Number: [singular]}	
ἀδελφὴ	ἀδελφή	{Case: [nominative], Gender: [feminine], Number: [singular]}	a sister
Ἠλέκτρα.	Ἠλέκτρα	{Case: [accusative], Gender: [feminine], Number: [singular]}	Electra
Στρόφιον	Στρόφιον	{Case: [accusative], Gender: [masculine], Number: [singular]}	
Φωκίδι	Φωκίς	{Case: [dative], Gender: [feminine], Number: [singular]}	Phocis
2.16.2	2.16.2	{Case: [genitive], Gender: [masculine], Number: [singular]}	
Ἐνταῦθα	Ἐνταῦθα	{}	
οἰκείως	οἰκείως	{Degree: [positive]}	
Πυλάδην	Πυλάδη	{Case: [accusative], Gender: [masculine], Number: [singular]}	
Στροφίου	Στρόφιος	{Case: [genitive], Gender: [masculine], Number: [singular]}	Strophius
φιλίαν	φιλία	{Case: [accusative], Gender: [feminine], Number: [singular]}	friendly love, affection, friendship
παροιμίαν.	παροιμίανον	{Case: [accusative], Gender: [feminine], Number: [singular]}	
ἥβην	ἥβη	{Case: [accusative], Gender: [feminine], Number: [singular]}	manhood, youthful prime, youth
ἀφανὴς	ἀφανής	{Case: [nominative], Degree: [positive], Gender: [masculine], Number: [singular]}	unseen, invisible, viewless
ἐπ	ἐς	{Case: [nominative], Definiteness: [definite], Gender: [masculine], Number: [singular], PrononimalType: [demonstrative]}	
Ἄργος,	Ἄργος,	{Case: [nominative], Gender: [masculine], Number: [singular]}	
φόνου	φόνος	{Case: [genitive], Gender: [masculine], Number: [singular]}	murder, homicide, slaughter
2.16.3	2.16.3	{Case: [genitive], Gender: [masculine], Number: [singular]}	
Μανίας	Μανία	{Case: [genitive], Gender: [feminine], Number: [singular]}	Mania (long alpha, unlike μανία madness), a slave name
Ἐρινύων	Ἐρινύων	{Case: [genitive], Gender: [masculine], Number: [plural]}	
Ἀθήναις.	Αθῆναι	{Case: [dative], Gender: [feminine], Number: [plural]}	
Ἀρείῳ	Ἀρεῖος	{Case: [dative], Gender: [masculine], Number: [singular]}	
πάγῳ	πάγος	{Case: [dative], Gender: [masculine], Number: [singular]}	rock; frost, solid
ἐνοικοῦντες	ἐνοικέω	{Case: [nominative], Gender: [masculine], Number: [plural], Tense: [present], VerbForm: [participle], Voice: [active]}	to dwell in
ἀναγνωρίσασα	ἀναγνωρίζω	{Aspect: [perfective], Case: [nominative], Gender: [feminine], Number: [singular], Tense: [past], VerbForm: [participle], Voice: [active]}	recognize
ἐκφεύγει	ἐκφεύγω	{Mood: [indicative], Number: [singular], Person: [third], Tense: [present], VerbForm: [finite], Voice: [active]}	to flee out
Πελοπόννησον	Πελοπόννησος	{Case: [accusative], Gender: [feminine], Number: [singular]}	the Peloponnesus
βασιλείαν	βασιλεία	{Case: [accusative], Gender: [feminine], Number: [singular]}	a kingdom, dominion
Μυκήναις	Μυκήνη	{Case: [dative], Gender: [feminine], Number: [plural]}	Mycene, Mycenae
Ἑρμιόνην	Ἑρμιόνη	{Case: [accusative], Gender: [masculine], Number: [singular]}	Hermione
2.17.0	2.17.0	{Case: [genitive], Gender: [masculine], Number: [singular]}	
Croesus	Croesus	{Case: [genitive], Degree: [positive], Gender: [masculine], Number: [singular]}	
2.17.1	2.17.1	{Case: [genitive], Gender: [masculine], Number: [singular]}	
Λυδῶν	Λυδός	{Case: [genitive], Gender: [masculine], Number: [plural]}	(adj) Lydian; (subst) Lydus, their mythical ancestor
Βουλόμενος	ἀούλομαι	{Case: [nominative], Gender: [masculine], Number: [singular], Tense: [present], VerbForm: [participle], Voice: [middle]}	
πρέσβεις	πρέσβος	{Case: [accusative], Gender: [masculine], Number: [plural]}	an object of reverence
Περσικὴν	Περσικός	{Case: [accusative], Degree: [positive], Gender: [feminine], Number: [singular]}	Persian
ές	τίνω	{Aspect: [perfective], Number: [singular], Tense: [past], VerbForm: [infinitive], Voice: [active]}	to pay a price
χώραν.	χώραν	{Case: [accusative], Gender: [feminine], Number: [singular]}	
Κῦρος,	Κῦρος,	{Case: [nominative], Gender: [masculine], Number: [singular]}	
ἀγείρας	ἀγείρω	{Aspect: [perfective], Case: [nominative], Gender: [masculine], Number: [singular], Tense: [past], VerbForm: [participle], Voice: [active]}	to bring together, gather together
Μάχης	Μάχης	{Case: [genitive], Gender: [feminine], Number: [singular]}	
διέστησαν.	διΐστημι	{Aspect: [perfective], Mood: [indicative], Number: [plural], Person: [third], Tense: [past], VerbForm: [finite], Voice: [active]}	set apart, separate
2.17.2	2.17.2	{Case: [genitive], Gender: [masculine], Number: [singular]}	
ξυλλέγειν,	ξυλλέγω	{Tense: [present], VerbForm: [infinitive], Voice: [active]}	
ἐπανῆλθεν,	ἐπανέρχομαι	{Aspect: [perfective], Mood: [indicative], Number: [singular], Person: [third], Tense: [past], VerbForm: [finite], Voice: [active]}	to go back, return
ἐπιόντι	ἔπειμι	{Case: [dative], Gender: [masculine], Number: [singular], Tense: [present], VerbForm: [participle], Voice: [active]}	be there (in addition, later, set over)
ἐνιαυτῷ	ἐνιαυτός	{Case: [dative], Gender: [masculine], Number: [singular]}	year
καταστῆναι.	καταστηναίω	{Aspect: [perfective], Tense: [past], VerbForm: [infinitive], Voice: [active]}	
Κῦρος	Κῦρος	{Case: [nominative], Gender: [masculine], Number: [singular]}	Cyrus
τάχιστα	ταχέως	{Degree: [superlative]}	
μητρόπολιν.	μητρόπολις	{Case: [accusative], Gender: [feminine], Number: [singular]}	the mother-state
Ἀφικόμενός	Ἀφικόμενος	{Case: [nominative], Gender: [masculine], Number: [singular]}	
προσταχθέντα,	προστάσσω	{Aspect: [perfective], Case: [accusative], Gender: [masculine], Number: [plural], Tense: [past], VerbForm: [participle], Voice: [passive]}	to order
ἱππεάς	ἱππεή	{Case: [accusative], Gender: [masculine], Number: [plural]}	
εἰσίν.	οἶσι	{Mood: [indicative], Number: [plural], Person: [third], Tense: [present], VerbForm: [finite], Voice: [active]}	
Ἐμηχανήσατο	μηχανάομαι	{Aspect: [perfective], Mood: [indicative], Number: [singular], Person: [third], Tense: [past], VerbForm: [finite], Voice: [middle]}	to prepare, make ready
καμήλους	κάμηλος	{Case: [accusative], Gender: [feminine], Number: [plural]}	a camel
σῖτον	σῖτος	{Case: [accusative], Gender: [masculine], Number: [singular]}	grain
σκεύη	σκεῦος	{Case: [accusative], Gender: [neuter], Number: [plural]}	a vessel
ἀντικατέστησεν	ἀντικαθίστημι	{Aspect: [perfective], Mood: [indicative], Number: [singular], Person: [third], Tense: [past], VerbForm: [finite], Voice: [active]}	to lay down
ἀεί,	ἀεί,	{}	
ἀνεχόμενοι	ἀνέχω	{Case: [nominative], Gender: [masculine], Number: [plural], Tense: [present], VerbForm: [participle], Voice: [middle]}	to hold up; (mid.) endure, put up with
ἱδεάν	ἱδεά	{Case: [accusative], Gender: [feminine], Number: [singular]}	
ὀσμῆς	ὀσμή	{Case: [genitive], Gender: [feminine], Number: [singular]}	a smell, scent, odour
ὀσφραινόμενοι.	ὀσφραίνομαι	{Case: [nominative], Gender: [masculine], Number: [plural], Tense: [present], VerbForm: [participle], Voice: [middle]}	to catch scent of, smell, scent, track
2.17.3	2.17.3	{Case: [genitive], Gender: [masculine], Number: [singular]}	
ἀνεστρέφοντο,	ἀναστρέφω	{Case: [genitive], Gender: [masculine], Number: [singular], Tense: [present], VerbForm: [participle], Voice: [active]}	to turn upside down, upset
πυρὰν	πυρά	{Case: [accusative], Gender: [feminine], Number: [singular]}	(n.pl.) watch-fires
ἀνεβίβασεν	ἀναβιβάζω	{Aspect: [perfective], Mood: [indicative], Number: [singular], Person: [third], Tense: [past], VerbForm: [finite], Voice: [active]}	to make go up, cause to mount
πέδαις	πέδη	{Case: [dative], Gender: [feminine], Number: [plural]}	a fetter
πυράν.	πυράνη	{Case: [accusative], Gender: [feminine], Number: [singular]}	
ἐπεκαλέσατο	ἐπικαλέω	{Aspect: [perfective], Mood: [indicative], Number: [singular], Person: [third], Tense: [past], VerbForm: [finite], Voice: [middle]}	to call upon
ἐπιβοηθεῖν,	ἐπιβοάω	{Aspect: [perfective], Tense: [past], VerbForm: [infinitive], Voice: [active]}	to call upon
ἐδεδώκει.	ἐδδίδωμι	{Mood: [indicative], Number: [singular], Person: [third], Tense: [pluperfect], VerbForm: [finite], Voice: [active]}	
εὐχομένου	εὔχομαι	{Case: [genitive], Gender: [masculine], Number: [singular], Tense: [present], VerbForm: [participle], Voice: [middle]}	to pray, offer prayers, pay one's vows, make a vow
ὄμβρον	ὄμβρος	{Case: [accusative], Gender: [masculine], Number: [singular]}	storm of rain, thunder-storm
ἔσβεσεν.	σβέννυμι	{Aspect: [perfective], Mood: [indicative], Number: [singular], Person: [third], Tense: [past], VerbForm: [finite], Voice: [active]}	to quench, put out
αἰσθόμενος	αἰστάω	{Case: [nominative], Gender: [masculine], Number: [singular], Tense: [present], VerbForm: [participle], Voice: [middle]}	
2.18.0	2.18.0	{Case: [genitive], Gender: [masculine], Number: [singular]}	
Cyclops	Cyclops	{Case: [genitive], Gender: [masculine], Number: [singular]}	
2.18.1	2.18.1	{Case: [genitive], Gender: [masculine], Number: [singular]}	
Ὀδυσσεὺς	Ὀδυσσεύς	{Case: [nominative], Gender: [masculine], Number: [singular]}	Odysseus
ξυνεστράτευσε	ξυστράτω	{Aspect: [perfective], Mood: [imperative], Number: [singular], Person: [second], Tense: [past], VerbForm: [finite], Voice: [active]}	
Τροίαν,	Τροίαν	{Case: [accusative], Gender: [feminine], Number: [singular]}	
πανύστατος	πανύστατος	{Case: [nominative], Degree: [positive], Gender: [masculine], Number: [singular]}	last of all
ναύταις	ναύτης	{Case: [dative], Gender: [masculine], Number: [plural]}	a sailor, seaman; a fellow sailor
περιπλανηθεὶς	περιπλανάω	{Aspect: [perfective], Case: [nominative], Gender: [masculine], Number: [singular], Tense: [past], VerbForm: [participle], Voice: [passive]}	
2.18.2	2.18.2	{Case: [genitive], Gender: [masculine], Number: [singular]}	
πλανώμενος	πλανάω	{Case: [nominative], Gender: [masculine], Number: [singular], Tense: [present], VerbForm: [participle], Voice: [middle]}	to make to wander, lead wandering about
Κυκλώπων	Κύκλωπος	{Case: [genitive], Gender: [masculine], Number: [plural]}	
ὁρμίσαντες	ὁρμίζω	{Aspect: [perfective], Case: [nominative], Gender: [masculine], Number: [plural], Tense: [past], VerbForm: [participle], Voice: [active]}	to bring to a safe anchorage, bring into harbour, to moor, anchor
ἠπείρου	ἤπειρος	{Case: [genitive], Gender: [feminine], Number: [singular]}	terra-firma, the land
ὑστεραίᾳ	ὑστεραῖος	{Case: [dative], Degree: [positive], Gender: [feminine], Number: [singular]}	on the day after, the next day
πορθμὸν	πορθμός	{Case: [accusative], Gender: [masculine], Number: [singular]}	a ferry
διέβησαν	διαβαίνω	{Aspect: [perfective], Mood: [indicative], Number: [plural], Person: [third], Tense: [past], VerbForm: [finite], Voice: [active]}	to cross (a river, etc.); to stand with feet apart
Πολυφήμου	Πολύφημος	{Case: [genitive], Gender: [masculine], Number: [singular]}	Polyphemus
ἄντρον,	ἄντρων	{Case: [accusative], Gender: [neuter], Number: [singular]}	
κενὸν	κενός	{Case: [accusative], Degree: [positive], Gender: [neuter], Number: [singular]}	empty
ἐφεῦρον.	φεύρω	{Aspect: [imperfective], Mood: [indicative], Number: [plural], Person: [third], Tense: [past], VerbForm: [finite], Voice: [active]}	
ἄντρῳ·	ἄντρον	{Case: [dative], Gender: [neuter], Number: [singular]}	a cave, grot, cavern
προσουδίσας	προσουδίζω	{Aspect: [perfective], Case: [nominative], Gender: [masculine], Number: [singular], Tense: [past], VerbForm: [participle], Voice: [active]}	to dash to earth
Ἠπόρει	Ἠπόραι	{Case: [nominative], Gender: [masculine], Number: [singular]}	
ἐμηχανήσατο·	ἐμηχανάομαι	{Aspect: [perfective], Mood: [indicative], Number: [singular], Person: [third], Tense: [past], VerbForm: [finite], Voice: [middle]}	
οἶνον	οἶνος	{Case: [accusative], Gender: [masculine], Number: [singular]}	wine
πήρα	πήρα	{Case: [dative], Gender: [feminine], Number: [singular]}	a leathern pouch, a wallet, scrip
ὅνπερ	ὅσπ	{Case: [accusative], Gender: [masculine], Number: [singular], PrononimalType: [relative]}	
καταπιὼν	καταπίνω	{Case: [nominative], Gender: [masculine], Number: [singular], Tense: [present], VerbForm: [participle], Voice: [active]}	to gulp, swallow down
ἐκοιμήθη.	κοιμάομαι	{Aspect: [perfective], Mood: [indicative], Number: [singular], Person: [third], Tense: [past], VerbForm: [finite], Voice: [passive]}	sleep
σταυρόν	σταυρός	{Case: [accusative], Gender: [masculine], Number: [singular]}	an upright pale
ἀκονήσας	ἀκονάω	{Aspect: [perfective], Case: [nominative], Gender: [masculine], Number: [singular], Tense: [past], VerbForm: [participle], Voice: [active]}	to sharpen, whet
σκληρὸν	σκληρός	{Case: [accusative], Degree: [positive], Gender: [masculine], Number: [singular]}	hard
ἔωσεν	ἔθω	{Aspect: [perfective], Mood: [indicative], Number: [singular], Person: [third], Tense: [past], VerbForm: [finite], Voice: [active]}	be accustomed (see also εἴωθα)
ἕῳ	ἕος	{Case: [dative], Gender: [feminine], Number: [singular]}	
Κύκλωψ	Κύκλωψ	{Case: [nominative], Gender: [masculine], Number: [singular]}	a Cyclops
ἄντρου	ἄντρος	{Case: [genitive], Degree: [positive], Gender: [masculine], Number: [singular]}	
θύραν,	θύραν	{Case: [accusative], Gender: [feminine], Number: [singular]}	
ἐπιλαβόμενοι	ἐπιλαμβάνομαι	{Aspect: [perfective], Case: [nominative], Gender: [masculine], Number: [plural], Tense: [past], VerbForm: [participle], Voice: [middle]}	
κάτωθεν	κάτωθεν	{}	from below, up from below
ἐρίων	ἔριον	{Case: [genitive], Gender: [neuter], Number: [plural]}	wool
προβάτων	πρόβατον	{Case: [genitive], Gender: [neuter], Number: [plural]}	sheep; small cattle
δόλῳ	δόλος	{Case: [dative], Gender: [masculine], Number: [singular]}	a bait, trap, cunning
ἐξαπατήσαντες	ἐξαπατάω	{Aspect: [perfective], Case: [nominative], Gender: [masculine], Number: [plural], Tense: [past], VerbForm: [participle], Voice: [active]}	to deceive
Κύκλωπα,	Κύκλωπ	{Case: [accusative], Gender: [masculine], Number: [singular]}	
2.19.0	2.19.0	{Case: [genitive], Gender: [masculine], Number: [singular]}	
Perseus	Perseus	{Case: [genitive], Degree: [positive], Gender: [masculine], Number: [singular]}	
2.19.1	2.19.1	{Case: [genitive], Gender: [masculine], Number: [singular]}	
Περσεὺς	Περσεύς	{Case: [nominative], Gender: [masculine], Number: [singular]}	Perseus
Δανάης.	Δανάης	{Case: [genitive], Gender: [feminine], Number: [singular]}	
λάρνακος	λάρνακος	{Case: [genitive], Gender: [masculine], Number: [singular]}	
ἐπιθείς.	ἐπιθείνω	{Aspect: [perfective], Case: [nominative], Gender: [masculine], Number: [singular], Tense: [past], VerbForm: [participle], Voice: [active]}	
2.19.2	2.19.2	{Case: [genitive], Gender: [masculine], Number: [singular]}	
Σέριφον	Σέριφος	{Case: [accusative], Gender: [feminine], Number: [singular]}	Seriphos
νῆσον.	νῆσον	{Case: [accusative], Gender: [feminine], Number: [singular]}	
Ἁλιεὺς	Ἁλιεύς	{Case: [nominative], Gender: [masculine], Number: [singular]}	
Δίκτυς,	Δίκτυς,	{Case: [nominative], Gender: [masculine], Number: [singular]}	
Πολυδέκτην	Πολυδέκτη	{Case: [accusative], Gender: [masculine], Number: [singular]}	
ὑφ	ἐάφ	{}	
ἔπαθον.	παθονάω	{Aspect: [perfective], Mood: [indicative], Number: [plural], Person: [third], Tense: [past], VerbForm: [finite], Voice: [active]}	
Δανάην	Δανᾶα	{Case: [accusative], Gender: [feminine], Number: [singular]}	
2.19.3	2.19.3	{Case: [genitive], Gender: [masculine], Number: [singular]}	
Μεδούσης	Μέδουσα	{Case: [genitive], Gender: [feminine], Number: [singular]}	Medusa
Γοργοῦς.	Γοργοῦς	{Case: [genitive], Gender: [masculine], Number: [singular]}	
Βοηθοῦντος	Βοηθοῦς	{Case: [genitive], Gender: [masculine], Number: [singular]}	
Ἑρμοῦ	Ἑρμός	{Case: [genitive], Gender: [masculine], Number: [singular]}	
Γραίας	Γραΐα	{Case: [genitive], Gender: [feminine], Number: [singular]}	
Γοργόνων	Γόργονος	{Case: [genitive], Gender: [masculine], Number: [plural]}	
ὁμαίμους,	ὁμαίμος	{Case: [accusative], Gender: [masculine], Number: [plural]}	
ὀδόντα	ὀδός	{Case: [accusative], Gender: [masculine], Number: [singular]}	a threshold > οὐδός
(τρεῖς	τρέω	{Mood: [indicative], Number: [plural], Person: [second], Tense: [present], VerbForm: [finite], Voice: [active]}	to flee from fear, flee away
ἀποδεικνύωσι	ἀποδείκνυμι	{Mood: [subjunctive], Number: [plural], Person: [third], Tense: [present], VerbForm: [finite], Voice: [active]}	display, appoint, demonstrate
Νύμφας	Νύμφας	{Case: [accusative], Gender: [feminine], Number: [plural]}	
πτηνὰ	πτηνός	{Case: [accusative], Degree: [positive], Gender: [neuter], Number: [plural]}	feathered, winged
πέδιλα	πέδιλον	{Case: [accusative], Gender: [neuter], Number: [plural]}	sandals
κόρυθα,	κόρυθα	{Case: [accusative], Gender: [feminine], Number: [singular]}	
ἥνπερ	τνισρός	{Case: [accusative], Gender: [feminine], Number: [singular], PrononimalType: [relative]}	
2.19.4	2.19.4	{Case: [genitive], Gender: [masculine], Number: [singular]}	
νυμφῶν	νυμφός	{Case: [genitive], Gender: [masculine], Number: [plural]}	
δρέπανον	δρέπανον	{Case: [accusative], Gender: [neuter], Number: [singular]}	a scythe
ἀπ	ἄς	{Case: [genitive], Definiteness: [definite], Gender: [feminine], Number: [singular], PrononimalType: [demonstrative]}	
κάτοπτρον,	κάτοπτρον	{Case: [accusative], Gender: [neuter], Number: [singular]}	a mirror
ἀέρα	ἀήρ	{Case: [accusative], Gender: [masculine], Number: [singular]}	the lower air, the air
ἀναπτόμενος	ἀνάπτω	{Case: [nominative], Gender: [masculine], Number: [singular], Tense: [present], VerbForm: [participle], Voice: [middle]}	to make fast on
καθευδούσας	καθεύδω	{Case: [accusative], Gender: [feminine], Number: [plural], Tense: [present], VerbForm: [participle], Voice: [active]}	to lie down to sleep, sleep
Μέδουσαν	οέδειμι	{Case: [accusative], Gender: [feminine], Number: [singular], Tense: [present], VerbForm: [participle], Voice: [active]}	
(οὐ	(οὐ	{}	
ἀπέτεμεν	ἀποτίθημι	{Aspect: [perfective], Mood: [indicative], Number: [singular], Person: [first], Tense: [past], VerbForm: [finite], Voice: [active]}	to put away, stow away
κεφαλήν.	κεφαλήν	{Case: [accusative], Gender: [feminine], Number: [singular]}	
2.19.5	2.19.5	{Case: [genitive], Gender: [masculine], Number: [singular]}	
Ἐνθεῖς	Ἐνθέας	{Case: [nominative], Gender: [masculine], Number: [singular]}	
κόρυθα	κόρυθον	{Case: [accusative], Gender: [feminine], Number: [singular]}	
ἠμφιεσμένον.	ἀμφιέννυμι	{Aspect: [perfective], Case: [accusative], Gender: [neuter], Number: [singular], Tense: [past], VerbForm: [participle], Voice: [passive]}	to put round
ἐντεῦθεν	ἐντεῦθεν	{}	hence
Αἰθιοπίαν	Αἰθιοπία	{Case: [accusative], Gender: [feminine], Number: [singular]}	Ethiopia (LSJ Αἰθίοψ)
ἔγημε	ἔγω	{Aspect: [perfective], Mood: [indicative], Number: [singular], Person: [third], Tense: [past], VerbForm: [finite], Voice: [active]}	
Ἀνδρομέδαν,	Ἀνδρομέδα	{Case: [accusative], Gender: [feminine], Number: [singular]}	Andromeda
Ἄργει	Ἄργος	{Case: [dative], Gender: [feminine], Number: [singular]}	Argos
2.20.0	2.20.0	{Case: [genitive], Gender: [masculine], Number: [singular]}	
Jason	Jason	{Case: [genitive], Degree: [positive], Gender: [masculine], Number: [singular]}	
2.20.1	2.20.1	{Case: [genitive], Gender: [masculine], Number: [singular]}	
Αἴσων,	Αἴσων	{Case: [nominative], Gender: [masculine], Number: [singular]}	Aeson
Ἰωλκίᾳ	Ἰωλκία	{Case: [dative], Gender: [feminine], Number: [singular]}	
Πελίου.	Πελίοι	{Case: [genitive], Gender: [masculine], Number: [singular]}	
Φεύγων	Φεῦγος	{Case: [nominative], Gender: [masculine], Number: [plural]}	
Κένταυρον	Κένταυρος	{Case: [accusative], Gender: [masculine], Number: [singular]}	a Centaur
Χείρωνα	Χείρων	{Case: [accusative], Gender: [masculine], Number: [singular]}	Cheiron
εὐκλεέστατον	εὐκλεής	{Case: [accusative], Degree: [superlative], Gender: [masculine], Number: [singular]}	of good report, famous, glorious
ἐπαίδευεν	παιδεύω	{Aspect: [imperfective], Mood: [indicative], Number: [singular], Person: [third], Tense: [past], VerbForm: [finite], Voice: [active]}	to bring up
Πηλίῳ	Πήλιον	{Case: [dative], Gender: [neuter], Number: [singular]}	Pelion
Ἀσκληπιὸν	Ἀσκληπιός	{Case: [accusative], Degree: [positive], Gender: [masculine], Number: [singular]}	Asclepius
Πηλεά	Πηλεά	{Case: [accusative], Gender: [masculine], Number: [singular]}	
ἡρώων.	ἡρώων	{Case: [genitive], Gender: [masculine], Number: [plural]}	
θηρᾶν	θηραίνω	{Tense: [present], VerbForm: [infinitive], Voice: [active]}	
λαγὼς	λαγχάνω	{Aspect: [perfective], Case: [nominative], Gender: [masculine], Number: [singular], Tense: [past], VerbForm: [participle], Voice: [active]}	to obtain by lot, by fate, by the will of the gods
αἶγας	αἶγυς	{Case: [accusative], Gender: [masculine], Number: [plural]}	
παλαίειν	παλαίω	{Tense: [present], VerbForm: [infinitive], Voice: [active]}	to wrestle
πὺξ	πυάω	{Aspect: [perfective], Number: [singular], Tense: [past], VerbForm: [infinitive], Voice: [active]}	
αὐλὸν	αὐλός	{Case: [accusative], Gender: [masculine], Number: [singular]}	aulos (wind instrument resembling oboe)
λύραν,	λύραν	{Case: [accusative], Gender: [feminine], Number: [singular]}	
νοσοῦντας	νοσέω	{Case: [accusative], Gender: [masculine], Number: [plural], Tense: [present], VerbForm: [participle], Voice: [active]}	to be sick, ill, to ail
ἐπιτηδεύματα	ἐπιτήδευμα	{Case: [accusative], Gender: [neuter], Number: [plural]}	a pursuit, business, practice
ἔνδοξά	ἔνδοξος	{Case: [accusative], Degree: [positive], Gender: [neuter], Number: [plural]}	held in esteem
ἐστιν.	ἔστινον	{Case: [genitive], Gender: [masculine], Number: [singular]}	
2.20.2	2.20.2	{Case: [genitive], Gender: [masculine], Number: [singular]}	
ἡβῶντος,	ἡβάνω	{Case: [genitive], Gender: [masculine], Number: [singular], Tense: [present], VerbForm: [participle], Voice: [active]}	
ἐξιόντα	ἔξειμι	{Case: [accusative], Gender: [masculine], Number: [singular], Tense: [present], VerbForm: [participle], Voice: [active]}	go out
Πελίαν	Πελίαι	{Case: [accusative], Gender: [masculine], Number: [singular]}	
ἀξιοῦν	ἀξιός	{Case: [accusative], Degree: [positive], Gender: [masculine], Number: [singular]}	
ἀδίκως	ἀδίκως	{Degree: [positive]}	
κλαπεῖσαν,	κλαπέω	{Aspect: [perfective], Case: [accusative], Gender: [feminine], Number: [plural], Tense: [past], VerbForm: [participle], Voice: [passive]}	
ἀποδιδόναι.	ἀποδιδοναίνω	{Tense: [present], VerbForm: [infinitive], Voice: [active]}	
Πελίας	Πελία	{Case: [genitive], Gender: [feminine], Number: [singular]}	
Κολχίδι	Κολχίς	{Case: [dative], Gender: [feminine], Number: [singular]}	Colchis
κατοίσει.	κατοισείω	{Mood: [indicative], Number: [singular], Person: [third], Tense: [future], VerbForm: [finite], Voice: [active]}	
Ξυνέλεξεν	Ξυναλέγω	{Aspect: [perfective], Mood: [indicative], Number: [singular], Person: [third], Tense: [past], VerbForm: [finite], Voice: [active]}	
μεθ	μεθ	{Case: [accusative], Gender: [masculine], Number: [plural]}	
Τελαμῶνα	Τελαμών	{Case: [accusative], Gender: [masculine], Number: [singular]}	Telamon
Αἴαντος	Αἴας	{Case: [genitive], Gender: [masculine], Number: [singular]}	Ajax
Τῖφυν	Τῖφυς	{Case: [accusative], Gender: [masculine], Number: [singular]}	
κυβερνήτην	κυβερνήτης	{Case: [accusative], Gender: [masculine], Number: [singular]}	a steersman, helmsman, pilot
πεντήκοντα.	πεντήκων	{Case: [accusative], Gender: [feminine], Number: [singular]}	
2.20.3	2.20.3	{Case: [genitive], Gender: [feminine], Number: [singular]}	
Μήδεια,	Μήδεια	{Case: [nominative], Gender: [masculine], Number: [singular]}	Medea
Κολχικοῦ	Κολχικός	{Case: [genitive], Degree: [positive], Gender: [masculine], Number: [singular]}	
ἐπεκούρησεν.	ἐπικορέω	{Aspect: [perfective], Mood: [indicative], Number: [singular], Person: [third], Tense: [past], VerbForm: [finite], Voice: [active]}	
παντοίων	παντοῖος	{Case: [genitive], Degree: [positive], Gender: [masculine], Number: [plural]}	of all sorts
φαρμάκων	φάρμακον	{Case: [genitive], Gender: [masculine], Number: [plural]}	a drug, medicine
φίλτρων	φίλτρον	{Case: [genitive], Gender: [neuter], Number: [plural]}	a love-charm
ταύρους	ταῦρος	{Case: [accusative], Gender: [masculine], Number: [plural]}	a bull
ἐκπνέοντας	ἐκπνέω	{Case: [accusative], Gender: [masculine], Number: [plural], Tense: [present], VerbForm: [participle], Voice: [active]}	to breathe out
δαμάζοι,	δαμάζω	{Mood: [optative], Number: [singular], Person: [third], Tense: [present], VerbForm: [finite], Voice: [active]}	to overpower, tame, conquer, subdue
μυρίους	μύριοι	{Case: [accusative], Gender: [masculine], Number: [plural]}	ten thousand
νικῴη.	νικῴα	{Case: [nominative], Gender: [masculine], Number: [singular]}	
δράκοντα	δράκων	{Case: [accusative], Gender: [masculine], Number: [singular]}	dragon, serpent
ἀποκομίζων	ἀποκομίζω	{Case: [nominative], Gender: [masculine], Number: [singular], Tense: [present], VerbForm: [participle], Voice: [active]}	to carry away, escort
Μήδειαν.	Μήδειαν	{Case: [accusative], Gender: [feminine], Number: [singular]}	
Πελίου	Πέλιος	{Case: [genitive], Gender: [masculine], Number: [singular]}	
ἀπεδέξατο.	ἀποδέχομαι	{Aspect: [perfective], Mood: [indicative], Number: [singular], Person: [third], Tense: [past], VerbForm: [finite], Voice: [middle]}	to accept from
2.21.0	2.21.0	{Case: [genitive], Gender: [masculine], Number: [singular]}	
Ulysses	Ulysses	{Case: [genitive], Degree: [positive], Gender: [feminine], Number: [singular]}	
Argus	οὖς	{Case: [genitive], Definiteness: [definite], Gender: [masculine], Number: [singular], PrononimalType: [demonstrative]}	ear
2.21.1	2.21.1	{Case: [genitive], Gender: [masculine], Number: [singular]}	
ἐπανῆλθον	πανέρχομαι	{Aspect: [perfective], Mood: [indicative], Number: [plural], Person: [third], Tense: [past], VerbForm: [finite], Voice: [active]}	
Ἰθάκῃ	Ἰθάκη	{Case: [dative], Gender: [feminine], Number: [singular]}	Ithaca
ᾤκησεν.	ἀκηθέω	{Aspect: [perfective], Mood: [indicative], Number: [singular], Person: [third], Tense: [past], VerbForm: [finite], Voice: [active]}	
πανταχοῦ	πανταχοῦ	{}	everywhere
καθορμίζεσθαι	καθορμίζω	{Tense: [present], VerbForm: [infinitive], Voice: [middle]}	to bring
χωρία,	χωρία	{Case: [accusative], Gender: [neuter], Number: [plural]}	
φίλην	φίλη	{Case: [accusative], Gender: [feminine], Number: [singular]}	
Ἰθάκην.	Ἰθάκην	{Case: [accusative], Gender: [feminine], Number: [singular]}	
Εἴκοσιν	Εἴκοσι	{}	
ἕτη	ἕτη	{Case: [nominative], Gender: [feminine], Number: [singular]}	
ἐφοίτα,	φοιτάω	{Aspect: [imperfective], Mood: [indicative], Number: [singular], Person: [third], Tense: [past], VerbForm: [finite], Voice: [active]}	to go to and fro, up and down, to stalk
ἄλλοτε	ἄλλοτε	{}	at another time, at other times
χειμῶνος,	χειμών	{Case: [genitive], Gender: [masculine], Number: [singular]}	winter; storm, stormy weather
Αἴολος	Αἴολος	{Case: [nominative], Gender: [masculine], Number: [singular]}	Aeolus
αὐτῷ,	αὐτῷ,	{}	
ἅνω	ἅς	{Case: [genitive], Gender: [masculine], Number: [singular], Person: [third], PrononimalType: [personal]}	
ἀνέμοις.	ἀνέμοιτος	{Case: [dative], Gender: [masculine], Number: [plural]}	
2.21.2	2.21.2	{Case: [genitive], Degree: [positive], Gender: [masculine], Number: [singular]}	
ἐπώκειλε	ἐπόκειλαι	{Aspect: [perfective], Mood: [indicative], Number: [singular], Person: [third], Tense: [past], VerbForm: [finite], Voice: [active]}	
λιμένα.	λιμήν	{Case: [accusative], Gender: [masculine], Number: [singular]}	a harbour, haven, creek
λάθρᾳ	λάθρᾳ	{}	
συβώτου	σύβωτος	{Case: [genitive], Degree: [positive], Gender: [masculine], Number: [singular]}	
Εὐμαίου	Εὐμαῖος	{Case: [genitive], Gender: [masculine], Number: [singular]}	
καλύβην	καλύβη	{Case: [accusative], Gender: [feminine], Number: [singular]}	a hut, cabin, cell
ἐπιγιγνώσκων	ἐπιγιγνώσκω	{Case: [nominative], Gender: [masculine], Number: [singular], Tense: [present], VerbForm: [participle], Voice: [active]}	to look upon, witness, observe
γοὶρ	γοῦρ	{}	
ἀπεδήμει.	ἀποδημείω	{Aspect: [imperfective], Mood: [indicative], Number: [singular], Person: [first], Tense: [past], VerbForm: [finite], Voice: [active]}	
ἐγγὺς	ἐγγύς	{Degree: [positive]}	near, nigh, at hand
χαμαὶ	χαμαί	{}	on the earth, on the ground
κύων	κύον	{Case: [nominative], Gender: [masculine], Number: [singular]}	
ἐκίνει	κίνω	{Aspect: [imperfective], Mood: [indicative], Number: [singular], Person: [third], Tense: [past], VerbForm: [finite], Voice: [active]}	
ἔσαινεν,	σαίω	{Aspect: [imperfective], Mood: [indicative], Number: [singular], Person: [third], Tense: [past], VerbForm: [finite], Voice: [active]}	
ἤρκεσεν	ἀρκέω	{Aspect: [perfective], Mood: [indicative], Number: [singular], Person: [third], Tense: [past], VerbForm: [finite], Voice: [active]}	to ward off; to be sufficient
ἰσχὺς	ἰσχύς	{Case: [nominative], Gender: [feminine], Number: [singular]}	strength
Ὀδυσσέα	Ὀδυσσῆς	{Case: [accusative], Gender: [masculine], Number: [singular]}	
ὄμμασι	ὄμμα	{Case: [dative], Gender: [neuter], Number: [plural]}	the eye
τηρῶν.	τηρόσσω	{Case: [nominative], Gender: [masculine], Number: [singular], Tense: [present], VerbForm: [participle], Voice: [active]}	
2.21.3	2.21.3	{Case: [genitive], Gender: [masculine], Number: [singular]}	
Ὀδυσσεύς,	Ὀδυσσεύς,	{Case: [nominative], Gender: [masculine], Number: [singular]}	
κύνα,	κύων	{Case: [accusative], Gender: [masculine], Number: [singular]}	a dog (pr. n., a Cynic)
σκύλακα	σκύλαξ	{Case: [accusative], Gender: [masculine], Number: [singular]}	a young dog, whelp, puppy
κατ	κατ	{}	
καταγηρήσαντα	καταγηρέω	{Aspect: [perfective], Case: [accusative], Gender: [masculine], Number: [singular], Tense: [past], VerbForm: [participle], Voice: [active]}	
ἐδάκρυσεν.	δακρύω	{Aspect: [perfective], Mood: [indicative], Number: [singular], Person: [third], Tense: [past], VerbForm: [finite], Voice: [active]}	to weep, shed tears
Εὔμαιον.	Εὔμαιον	{Case: [accusative], Gender: [masculine], Number: [singular]}	
δε,	δε,	{}	
Ὀδυσσέως	Ὀδύσσαι	{Case: [genitive], Gender: [masculine], Number: [singular]}	
λύπῃ	λύπη	{Case: [dative], Gender: [feminine], Number: [singular]}	pain of body
θεραπόντων	θεράπων	{Case: [genitive], Gender: [masculine], Number: [plural]}	a waiting-man, attendant
οὕτε	οὕτε	{}	
ἀπῴχετο	ἀπιχνέομαι	{Aspect: [imperfective], Mood: [indicative], Number: [singular], Person: [third], Tense: [past], VerbForm: [finite], Voice: [middle]}	
Ἰλίου	Ἴλιος	{Case: [genitive], Gender: [masculine], Number: [singular]}	Ilian, Trojan
ἐκπολιορκηθέντος	ἐκπολιορκέω	{Aspect: [perfective], Case: [genitive], Gender: [masculine], Number: [singular], Tense: [past], VerbForm: [participle], Voice: [passive]}	to force a besieged town to surrender
προσηνέχθη.	προσφέρω	{Aspect: [perfective], Mood: [indicative], Number: [singular], Person: [third], Tense: [past], VerbForm: [finite], Voice: [passive]}	to bring to
2.22.0	2.22.0	{Case: [genitive], Gender: [masculine], Number: [singular]}	
Diomede	Diomede	{Case: [genitive], Degree: [positive], Gender: [masculine], Number: [singular]}	
2.22.1	2.22.1	{Case: [genitive], Gender: [masculine], Number: [singular]}	
Διομήδης	Διομήδης	{Case: [nominative], Gender: [feminine], Number: [singular]}	Diomedes (Zeus-counselled)
Τυδέως	Τυδεύς	{Case: [genitive], Gender: [masculine], Number: [singular]}	Tydeus
προέσχε	προέχω	{Aspect: [perfective], Mood: [indicative], Number: [singular], Person: [third], Tense: [past], VerbForm: [finite], Voice: [active]}	to hold before, to pretend; to jut out, to excel
ἀνδρείᾳ,	ἀνδρεία	{Case: [dative], Gender: [feminine], Number: [singular]}	manliness, manhood, manly spirit
Μαχόμενος	Μαχόμενος	{Case: [nominative], Gender: [masculine], Number: [singular]}	
Αἰνείαν	Αἴνεια	{Case: [accusative], Gender: [feminine], Number: [singular]}	
Πανδάρῳ	Πάνδαρος	{Case: [dative], Gender: [masculine], Number: [singular]}	Pandarus
Λυκάονος	Λυκάων	{Case: [genitive], Gender: [masculine], Number: [singular]}	Lycaon
ἐξεπήδησε	ἐκπηδάω	{Aspect: [perfective], Mood: [indicative], Number: [singular], Person: [third], Tense: [past], VerbForm: [finite], Voice: [active]}	to leap out
ῥίψας	ῥίπτω	{Aspect: [perfective], Case: [nominative], Gender: [masculine], Number: [singular], Tense: [past], VerbForm: [participle], Voice: [active]}	to throw, cast, hurl
Πανδάρου.	Πανδάρη	{Case: [genitive], Gender: [masculine], Number: [singular]}	
τετρωμένος	τρώω	{Aspect: [perfective], Case: [nominative], Gender: [masculine], Number: [singular], Tense: [past], VerbForm: [participle], Voice: [passive]}	
κατεπήδησεν	καταπηδάω	{Aspect: [perfective], Mood: [indicative], Number: [singular], Person: [third], Tense: [past], VerbForm: [finite], Voice: [active]}	to leap down
ἐπιβαλῶν	ἐπιβάλλω	{Case: [nominative], Gender: [masculine], Number: [singular], Tense: [future], VerbForm: [participle], Voice: [active]}	to throw
2.22.2	2.22.2	{Case: [accusative], Gender: [masculine], Number: [singular]}	
μηρὸν	μηρός	{Case: [accusative], Gender: [masculine], Number: [singular]}	the thigh
πληγεὶς	πληγίζω	{Aspect: [perfective], Case: [nominative], Gender: [masculine], Number: [singular], Tense: [past], VerbForm: [participle], Voice: [passive]}	
Διομήδους,	Διομήδουις	{Case: [accusative], Gender: [masculine], Number: [plural]}	
Ἀφροδίτη	Ἀφροδίτη	{Case: [nominative], Gender: [feminine], Number: [singular]}	Aphrodite
Ὀλύμπου	Ὄλυμπος	{Case: [genitive], Gender: [masculine], Number: [singular]}	Olympus
περικαλύπτουσα	περικαλύπτω	{Case: [nominative], Gender: [feminine], Number: [singular], Tense: [present], VerbForm: [participle], Voice: [active]}	to cover all round
νέφει.	νεφειόω	{Mood: [indicative], Number: [singular], Person: [third], Tense: [present], VerbForm: [finite], Voice: [active]}	
Ἀλλ	Ἀλλ	{Case: [nominative], Number: [singular]}	
ἔτρωσε	τρώννυμι	{Aspect: [perfective], Mood: [indicative], Number: [singular], Person: [third], Tense: [past], VerbForm: [finite], Voice: [active]}	
βοῶσα	βοάω	{Case: [nominative], Gender: [feminine], Number: [singular], Tense: [present], VerbForm: [participle], Voice: [active]}	to cry aloud, to shout
χεροῖν	χερό	{Case: [accusative], Gender: [feminine], Number: [singular]}	
Ὅλυμπον	Ὅλυμπός	{Case: [accusative], Gender: [feminine], Number: [singular]}	
Διώνη	Διώνη	{Case: [nominative], Gender: [feminine], Number: [singular]}	Dione
2.22.3	2.22.3	{Case: [genitive], Gender: [masculine], Number: [singular]}	
ἐπεχείρησε	ἐπιχειρέω	{Aspect: [perfective], Mood: [indicative], Number: [singular], Person: [third], Tense: [past], VerbForm: [finite], Voice: [active]}	to attempt, attack, put one’s hand to
ἠμύνατο	ἀμύνω	{Aspect: [imperfective], Mood: [indicative], Number: [singular], Person: [third], Tense: [past], VerbForm: [finite], Voice: [middle]}	to keep off, ward off
Διομήδους	Διομήδος	{Case: [accusative], Gender: [masculine], Number: [plural]}	
οὔπω	οὔπω	{Polarity: [neg]}	not yet
«Ἆρ	«Ἆρ	{Case: [vocative], Gender: [masculine], Number: [singular]}	
οὗ,	οὗ,	{}	
Τυδέως,	Τυδέως	{Case: [genitive], Gender: [masculine], Number: [singular]}	
δῆτα	δῆτα	{Case: [vocative], Gender: [masculine], Number: [singular]}	certainly, to be sure, of course
νῷ	νός	{Case: [dative], Gender: [feminine], Number: [singular], PrononimalType: [relative]}	
τόξου	τόξον	{Case: [genitive], Gender: [masculine], Number: [singular]}	a bow
ἀθανάτων;	ἀθανάτων	{Case: [genitive], Degree: [positive], Gender: [masculine], Number: [plural]}	
Παῦσαι	Παῦσαι	{Case: [nominative], Gender: [masculine], Number: [plural]}	
ἐπιχειρήσεως	ἐπιχείρησις	{Case: [genitive], Gender: [feminine], Number: [singular]}	an attempt, attack
θεόν.	θεόν	{Case: [accusative], Gender: [masculine], Number: [singular]}	
Μάλιστα	Μάλα	{Degree: [superlative]}	
2.23.0	2.23.0	{Case: [genitive], Gender: [masculine], Number: [singular]}	
Alexander	Alexander	{Case: [nominative], Degree: [positive], Gender: [masculine], Number: [singular]}	
2.23.1	2.23.1	{Case: [nominative], Gender: [masculine], Number: [singular]}	
Ἀλέξανδρος	Ἀλέξανδρος	{Case: [nominative], Gender: [masculine], Number: [singular]}	Alexander
Μακεδόνων,	Μακεδών	{Case: [genitive], Gender: [masculine], Number: [plural]}	a Macedonian
Φιλίππου	Φίλιππος	{Case: [genitive], Gender: [masculine], Number: [singular]}	Philip, Philippus; (pl.) the city, Philippi
διεδέξατο,	διαδέχομαι	{Aspect: [perfective], Mood: [indicative], Number: [singular], Person: [third], Tense: [past], VerbForm: [finite], Voice: [middle]}	to receive one from another
εἴκοσιν	εἴκοσιν	{}	
ὤν·	ὤν·	{}	
ἐχθροί.	ἐχθροῖος	{Case: [nominative], Degree: [positive], Gender: [masculine], Number: [plural]}	
ξυνελεῖν	ξυνέλω	{Tense: [present], VerbForm: [infinitive], Voice: [active]}	
ἔξω.	ἔξος	{Case: [accusative], Gender: [masculine], Number: [plural]}	
ἐξαίφνης	ἐξαίφνης	{}	suddenly
ἐπιστρατευσάμενος	ἐπιστρατεύω	{Aspect: [perfective], Case: [nominative], Gender: [masculine], Number: [singular], Tense: [past], VerbForm: [participle], Voice: [middle]}	to march against, make war upon
Θηβαῖοι	Θηβαῖος	{Case: [nominative], Degree: [positive], Gender: [masculine], Number: [plural]}	Theban
ξυνελθόντες	ξυνέρχομαι	{Aspect: [perfective], Case: [nominative], Gender: [masculine], Number: [plural], Tense: [past], VerbForm: [participle], Voice: [active]}	
2.23.2	2.23.2	{Case: [genitive], Gender: [masculine], Number: [singular]}	
ἀθροίσας	ἀθροίζω	{Aspect: [perfective], Case: [nominative], Gender: [masculine], Number: [singular], Tense: [past], VerbForm: [participle], Voice: [active]}	to gather together, to muster
Ἴστρον	Ἴστρος	{Case: [accusative], Gender: [masculine], Number: [singular]}	Ister, Danube
Βορέαν.	Βορέαν	{Case: [accusative], Gender: [masculine], Number: [singular]}	
ἀποτέθνηκεν	ἀποτνῄσκω	{Aspect: [perfective], Mood: [indicative], Number: [singular], Person: [third], Tense: [past], VerbForm: [finite], Voice: [active]}	
πολιτῶν	πολίτης	{Case: [genitive], Gender: [masculine], Number: [plural]}	(fellow) citizen
ἠνδραποδίσατο.	ἀνδραποδίζω	{Aspect: [perfective], Mood: [indicative], Number: [singular], Person: [third], Tense: [past], VerbForm: [finite], Voice: [middle]}	to reduce to slavery, enslave
2.23.3	2.23.3	{Case: [genitive], Gender: [masculine], Number: [singular]}	
Ἅμα	Ἅμα	{}	
ἦρι	ὥρι	{Case: [dative], Gender: [masculine], Number: [singular]}	
ἐπεραιώθη	περαιόω	{Aspect: [perfective], Mood: [indicative], Number: [singular], Person: [third], Tense: [past], VerbForm: [finite], Voice: [passive]}	to carry to the opposite side, carry over
Ἑλλήσποντον	Ἑλλήσποντος	{Case: [accusative], Gender: [masculine], Number: [singular]}	the Hellespont
χιλίους	χίλιοι	{Case: [accusative], Gender: [masculine], Number: [plural]}	a thousand
ἱππεάς,	ἱππεής	{Case: [accusative], Gender: [masculine], Number: [plural]}	
Γρανίκῳ	Γράνικος	{Case: [dative], Gender: [masculine], Number: [singular]}	Granicus
ἐκράτησεν.	ἐκρατέω	{Aspect: [perfective], Mood: [indicative], Number: [singular], Person: [third], Tense: [past], VerbForm: [finite], Voice: [active]}	
ξυλλεξας	ἐξαυλέγω	{Aspect: [perfective], Case: [nominative], Gender: [masculine], Number: [singular], Tense: [past], VerbForm: [participle], Voice: [active]}	
Γόρδιον	Γόρδιον	{Case: [accusative], Gender: [neuter], Number: [singular]}	Gordium
ἐξέλυσεν	ἐκλύω	{Aspect: [perfective], Mood: [indicative], Number: [singular], Person: [third], Tense: [past], VerbForm: [finite], Voice: [active]}	to loose, release, set free, from
ἅμμα,	ἅμμα	{Case: [accusative], Gender: [neuter], Number: [singular]}	anything tied
οὐδείς,	οὐδείς,	{}	
Ἀσίαν	Ἀσία	{Case: [accusative], Gender: [feminine], Number: [singular]}	Asia
Ἰσσὸν	Ἰσσός	{Case: [accusative], Gender: [masculine], Number: [singular]}	
ἀντιτάξας	ἀντιτάσσω	{Aspect: [perfective], Case: [nominative], Gender: [masculine], Number: [singular], Tense: [past], VerbForm: [participle], Voice: [active]}	to set opposite to, range in battle against
ἐπεφέρετο·	ἐπιφέρω	{Aspect: [imperfective], Mood: [indicative], Number: [singular], Person: [third], Tense: [past], VerbForm: [finite], Voice: [middle]}	to bring, put
ζωγρήσας	ζωγρέω	{Aspect: [perfective], Case: [nominative], Gender: [masculine], Number: [singular], Tense: [past], VerbForm: [participle], Voice: [active]}	to take alive, revive
Πρόσω	Πρόσω	{Degree: [positive]}	
ἀναβὰς	ἀναβαίνω	{Aspect: [perfective], Case: [nominative], Gender: [masculine], Number: [singular], Tense: [past], VerbForm: [participle], Voice: [active]}	to go up, mount, to go up to
ἔκτισεν.	κτίζω	{Aspect: [perfective], Mood: [indicative], Number: [singular], Person: [third], Tense: [past], VerbForm: [finite], Voice: [active]}	to found
κλεινοτάτη	κλεινός	{Case: [nominative], Degree: [superlative], Gender: [feminine], Number: [singular]}	famous, renowned, illustrious
Ἀλεξάνδρεια	Ἀλεξάνδρεια	{Case: [nominative], Gender: [feminine], Number: [singular]}	Alexandria
ἀφ	ἀς	{Case: [accusative], Gender: [masculine], Number: [singular]}	
ἐπωνόμασεν.	ἐπωνομασεμαι	{Aspect: [perfective], Mood: [indicative], Number: [singular], Person: [third], Tense: [past], VerbForm: [finite], Voice: [active]}	
2.23.4	2.23.4	{Case: [genitive], Gender: [masculine], Number: [singular]}	
ξυλλέξας	ξυλλέω	{Aspect: [perfective], Case: [nominative], Gender: [masculine], Number: [singular], Tense: [past], VerbForm: [participle], Voice: [active]}	
Γαυγαμήλων	Γαυγαμήλoς	{Case: [genitive], Gender: [masculine], Number: [plural]}	
ὄτι	ὄτις	{Case: [accusative], Gender: [neuter], Number: [singular]}	
προχωρεῖ	προχωρέω	{Mood: [indicative], Number: [singular], Person: [third], Tense: [present], VerbForm: [finite], Voice: [active]}	to go forward, advance
καταφυγὴν	καταφυγή	{Case: [accusative], Gender: [feminine], Number: [singular]}	a refuge, place of refuge
αὐτοῦ,	αὐτόω	{Aspect: [perfective], Mood: [indicative], Number: [singular], Person: [third], Tense: [past], VerbForm: [finite], Voice: [active]}	
Πάρθων	Πάρθοι	{Case: [genitive], Gender: [masculine], Number: [plural]}	the Parthians
ὑπηκόους	ὑπήκοος	{Case: [accusative], Degree: [positive], Gender: [masculine], Number: [plural]}	giving ear, listening to
Πωρον	Πωρᾶς	{Case: [accusative], Gender: [masculine], Number: [singular]}	
Ἰνδων	Ἴνδος	{Case: [genitive], Gender: [masculine], Number: [plural]}	
ἐπεστράτευεν·	ἐπιστράτω	{Aspect: [imperfective], Mood: [indicative], Number: [singular], Person: [third], Tense: [past], VerbForm: [finite], Voice: [active]}	
ἐνεθυμεῖτο,	ἐνεθυμέομαι	{Aspect: [imperfective], Mood: [indicative], Number: [singular], Person: [third], Tense: [past], VerbForm: [finite], Voice: [middle]}	
ἕνδεκα	ἕνδεκα	{}	eleven; the Eleven, police commissioners at Athens
Βαβυλῶνι.	Βαβυλώνι	{Case: [dative], Gender: [feminine], Number: [singular]}	
Φανερὸς	Φανερός	{Case: [nominative], Degree: [positive], Gender: [masculine], Number: [singular]}	
2.24.0	2.24.0	{Case: [genitive], Degree: [positive], Gender: [masculine], Number: [singular]}	
Suitors	Suitors	{Case: [genitive], Degree: [positive], Gender: [masculine], Number: [singular]}	
2.24.1	2.24.1	{Case: [genitive], Gender: [masculine], Number: [singular]}	
ἀνῆλθεν	ἀνέρχομαι	{Aspect: [perfective], Mood: [indicative], Number: [singular], Person: [third], Tense: [past], VerbForm: [finite], Voice: [active]}	to go up
ῥάκεσιν	ῥάκεσις	{Case: [dative], Gender: [neuter], Number: [plural]}	
πτωχῷ	πτωχός	{Case: [dative], Degree: [positive], Gender: [masculine], Number: [singular]}	beggar, begging, poor
ἐοικώς,	ἐοίκως	{Case: [nominative], Gender: [masculine], Number: [singular]}	
βακτηρίαν	βακτηρία	{Case: [accusative], Gender: [feminine], Number: [singular]}	a staff, cane
ἔχων.	χωνέω	{Case: [nominative], Gender: [masculine], Number: [singular], Tense: [present], VerbForm: [participle], Voice: [active]}	
μεγάρῳ	μέγαρον	{Case: [dative], Gender: [neuter], Number: [singular]}	a large room
οἶνον.	ὄνονα	{Case: [accusative], Gender: [masculine], Number: [singular]}	
Ἔσφαζον	σφάζω	{Aspect: [imperfective], Mood: [indicative], Number: [plural], Person: [third], Tense: [past], VerbForm: [finite], Voice: [active]}	to slay, slaughter
ἐδείπνουν.	δείπνω	{Aspect: [imperfective], Mood: [indicative], Number: [plural], Person: [third], Tense: [past], VerbForm: [finite], Voice: [active]}	
Πηνελόπειαν	Πηνελόπεια	{Case: [accusative], Gender: [feminine], Number: [singular]}	Penelope
Ἀλλ	ἅλλ	{Case: [nominative], Gender: [feminine], Number: [singular]}	
ἐπανιέναι.	ἐπανίημι	{Tense: [present], VerbForm: [infinitive], Voice: [active]}	to let loose at
θαλάμῳ	θάλαμος	{Case: [dative], Gender: [masculine], Number: [singular]}	an inner room
θεραπαίναις	θεραπαίνη	{Case: [dative], Gender: [feminine], Number: [plural]}	
ὀδυρομένη	ὀδύρω	{Case: [nominative], Gender: [feminine], Number: [singular], Tense: [present], VerbForm: [participle], Voice: [middle]}	
Ὀδυσσέως.	Ὀδύσσειται	{Case: [genitive], Gender: [masculine], Number: [singular]}	
2.24.2	2.24.2	{Case: [genitive], Gender: [masculine], Number: [singular]}	
κλείσας	κλείω	{Aspect: [perfective], Case: [nominative], Gender: [masculine], Number: [singular], Tense: [past], VerbForm: [participle], Voice: [active]}	to shut, close, bar
θύρας	θύρα	{Case: [genitive], Gender: [feminine], Number: [singular]}	a door
Τηλέμαχον	Τηλέμαχος	{Case: [accusative], Gender: [masculine], Number: [singular]}	Telemachus
συβώτην	συβώτης	{Case: [accusative], Gender: [masculine], Number: [singular]}	a swineherd
Φιλοίτιον	Φιλοίτιον	{Case: [accusative], Gender: [masculine], Number: [singular]}	
βουκόλον,	βούκολον	{Case: [accusative], Gender: [masculine], Number: [singular]}	
μέγα,	μέγα,	{Case: [nominative], Degree: [positive], Gender: [neuter], Number: [singular]}	
οὐδέποτε,	οὐδέποτε,	{}	
Εὔρυτος,	Εὔρυτος	{Case: [nominative], Gender: [masculine], Number: [singular]}	Eurytus
τείνειν	τείνω	{Tense: [present], VerbForm: [infinitive], Voice: [active]}	to stretch
Ἰφίτῳ,	Ἰφίτῳ,	{Case: [dative], Gender: [masculine], Number: [singular]}	
Ἴφιτος	Ἴφιτος	{Case: [nominative], Gender: [masculine], Number: [singular]}	Iphitus
νεανίσκῳ	νεανίσκος	{Case: [dative], Gender: [masculine], Number: [singular]}	a youth
Μεσσήνῃ.	Μεσσήνη	{Case: [dative], Gender: [feminine], Number: [singular]}	Messene
κατέλιπεν	καταλείπω	{Aspect: [perfective], Mood: [indicative], Number: [singular], Person: [third], Tense: [past], VerbForm: [finite], Voice: [active]}	to leave behind
Οδυσσεὺς	Οδυσσεύς	{Case: [nominative], Gender: [masculine], Number: [singular]}	
Τρῳάδα	Τρῳάς	{Case: [accusative], Gender: [feminine], Number: [singular]}	
Ἀθηναία	Ἀθήνη	{Case: [nominative], Gender: [feminine], Number: [singular]}	Athena
ἀνέμνησεν	ἀναμιμνῄσκω	{Aspect: [perfective], Mood: [indicative], Number: [singular], Person: [third], Tense: [past], VerbForm: [finite], Voice: [active]}	
ὀϊστοὺς	ὀϊστός	{Case: [accusative], Gender: [masculine], Number: [plural]}	arrow
φαρέτρα.	φαρέτραος	{Case: [dative], Degree: [positive], Gender: [feminine], Number: [singular]}	
ἀποροῦντι.	ἀπορούω	{Case: [dative], Gender: [masculine], Number: [singular], Tense: [present], VerbForm: [participle], Voice: [active]}	to dart away
2.24.3	2.24.3	{Case: [genitive], Gender: [masculine], Number: [singular]}	
Τείνας	Τείνα	{Case: [accusative], Gender: [feminine], Number: [plural]}	
μνηστῆρες	μνηστήρ	{Case: [nominative], Gender: [masculine], Number: [plural]}	a wooer, suitor
Ἀντινόου	Ἀντίνοος	{Case: [genitive], Gender: [masculine], Number: [singular]}	Antinous
χρυσοῦ	χρυσός	{Case: [genitive], Gender: [masculine], Number: [singular]}	gold
ποτηρίου,	ποτήριον	{Case: [genitive], Gender: [neuter], Number: [singular]}	a drinking-cup, wine-cup
διέτρωσε	διατρώννυμι	{Aspect: [perfective], Mood: [indicative], Number: [singular], Person: [third], Tense: [past], VerbForm: [finite], Voice: [active]}	
ὡσαύτως	ὡσαύτως	{}	in like manner, just so
οὐδένων	οὐδένας	{Case: [genitive], Gender: [masculine], Number: [plural]}	
ἐπόριζεν	πορίζω	{Aspect: [imperfective], Mood: [indicative], Number: [singular], Person: [third], Tense: [past], VerbForm: [finite], Voice: [active]}	to carry: to bring about, to furnish, provide, supply, procure, cause
ἀνέῳξε	ἀνοίγνυμι	{Aspect: [perfective], Mood: [indicative], Number: [singular], Person: [third], Tense: [past], VerbForm: [finite], Voice: [active]}	to open
δέ,	δέον	{Case: [nominative], Gender: [feminine], Number: [plural]}	that which is binding, needful, right, proper
χαρᾷ,	χαρά	{Case: [dative], Gender: [feminine], Number: [singular]}	joy, delight
δεσποίνῃ	δέσποινα	{Case: [dative], Gender: [feminine], Number: [singular]}	the mistress, lady of the house
Πηνελοπείᾳ	Πηνελοπεία	{Case: [dative], Gender: [feminine], Number: [singular]}	
ἴδοιεν.	ὁδοίω	{Aspect: [perfective], Mood: [optative], Number: [plural], Person: [third], Tense: [past], VerbForm: [finite], Voice: [active]}	
2.25.0	2.25.0	{Case: [genitive], Gender: [feminine], Number: [singular]}	
Penelope	Penelope	{Case: [genitive], Degree: [positive], Gender: [feminine], Number: [singular]}	
2.25.1	2.25.1	{Case: [genitive], Gender: [masculine], Number: [singular]}	
ἐμέμψατο	μέμπομαι	{Aspect: [perfective], Mood: [indicative], Number: [singular], Person: [third], Tense: [past], VerbForm: [finite], Voice: [middle]}	
«Τί	τέ	{Aspect: [perfective], Mood: [imperative], Number: [singular], Person: [second], Tense: [past], VerbForm: [finite], Voice: [active]}	
δῆτα,	δῆται	{Case: [accusative], Gender: [masculine], Number: [singular]}	
ἀληθῶς	ἀληθῶς	{Degree: [positive]}	
ἀρ	ἀύ	{Case: [genitive], Gender: [masculine], Number: [singular], PrononimalType: [personal]}	
2.25.2	2.25.2	{Mood: [imperative], Number: [singular], Person: [second], Tense: [present], VerbForm: [finite], Voice: [active]}	
«Μὰ	«Μὰ	{}	
Δία,	Ζιαί	{Case: [genitive], Gender: [masculine], Number: [singular]}	
ψευδής	ψευδής	{Case: [nominative], Gender: [masculine], Number: [singular]}	lying, false
πανοῦργος	πανοῦργος	{Case: [nominative], Gender: [masculine], Number: [singular]}	ready to do anything wicked, knavish, villanous
ἀποβαίνῃ·	ἀποβαίνω	{Mood: [subjunctive], Number: [singular], Person: [third], Tense: [present], VerbForm: [finite], Voice: [active]}	to step off from
ψεύδειν	ψεῦδος	{Case: [dative], Gender: [neuter], Number: [plural]}	a falsehood, untruth, lie
Ἀεὶ	μεί	{}	
ἠπίστησα	ἀπιστέω	{Aspect: [perfective], Mood: [indicative], Number: [singular], Person: [first], Tense: [past], VerbForm: [finite], Voice: [active]}	to disbelieve, distrust; to disobey
ἀπιστῶ.	ἀπιστῶς	{Degree: [positive]}	
Τεκμήρια	Τεκμήριος	{Case: [nominative], Degree: [positive], Gender: [neuter], Number: [plural]}	
νώ,	νίς	{Mood: [indicative], Number: [singular], Person: [first], Tense: [present], VerbForm: [finite], Voice: [active]}	
ἴσμεν.»	ἀσμενίω	{Aspect: [perfective], Mood: [indicative], Number: [plural], Person: [first], Tense: [past], VerbForm: [finite], Voice: [active]}	
2.25.3	2.25.3	{Case: [genitive], Gender: [masculine], Number: [singular]}	
Τηλεμάχου	Ταλεμάχης	{Case: [genitive], Gender: [masculine], Number: [singular]}	
λουσάμενός	λούω	{Aspect: [perfective], Case: [nominative], Gender: [masculine], Number: [singular], Tense: [past], VerbForm: [participle], Voice: [middle]}	to wash
ἐσθῆτα	ἐσθής	{Case: [accusative], Gender: [feminine], Number: [singular]}	dress, clothing, raiment
ἀμπεχόμενος,	ἀμπέχομαι	{Case: [nominative], Gender: [masculine], Number: [singular], Tense: [present], VerbForm: [participle], Voice: [middle]}	
ἐπανῆλθεν.	ἐπανρέρω	{Aspect: [perfective], Mood: [indicative], Number: [singular], Person: [third], Tense: [past], VerbForm: [finite], Voice: [active]}	
τεκμήρια	τεκμήριον	{Case: [accusative], Gender: [neuter], Number: [plural]}	a sure sign
σαφῶς	σαφῶς	{Degree: [positive]}	
ἐπειγομένη	πείγω	{Case: [nominative], Gender: [feminine], Number: [singular], Tense: [present], VerbForm: [participle], Voice: [middle]}	
ἠσπάζετο	ἀσπάζομαι	{Aspect: [imperfective], Mood: [indicative], Number: [singular], Person: [third], Tense: [past], VerbForm: [finite], Voice: [middle]}	to welcome kindly, bid welcome, greet
καταφιλοῦσα	καταφιλέω	{Case: [nominative], Gender: [feminine], Number: [singular], Tense: [present], VerbForm: [participle], Voice: [active]}	to kiss tenderly, to caress
χαρᾶς.	χαράτης	{Case: [genitive], Gender: [feminine], Number: [singular]}	
διηγεῖτο	διηγέομαι	{Aspect: [imperfective], Mood: [indicative], Number: [singular], Person: [third], Tense: [past], VerbForm: [finite], Voice: [middle]}	to set out in detail, describe in full
ἔπαθεν.	παθένχομαι	{Aspect: [perfective], Mood: [indicative], Number: [singular], Person: [third], Tense: [past], VerbForm: [finite], Voice: [active]}	
λόγος·	λόγος·	{Case: [nominative], Gender: [masculine], Number: [singular]}	
ἐκεκινδυνεύκει.	ἐκκινδυνεύω	{Mood: [indicative], Number: [singular], Person: [third], Tense: [pluperfect], VerbForm: [finite], Voice: [active]}	
2.25.4	2.25.4	{Case: [genitive], Gender: [masculine], Number: [singular]}	
ξύλινον	ξύλινος	{Case: [accusative], Degree: [positive], Gender: [masculine], Number: [singular]}	of wood, wooden
οὗπερ	ὅπειμι	{Case: [accusative], Gender: [neuter], Number: [singular], PrononimalType: [relative]}	
ἐξεπολιόρκησαν.	ἐκπολιόω	{Aspect: [perfective], Mood: [indicative], Number: [plural], Person: [third], Tense: [past], VerbForm: [finite], Voice: [active]}	
αὐτος	αὐτος	{Case: [genitive], Gender: [masculine], Number: [singular], Person: [third], PrononimalType: [personal]}	
πορείας	πορεία	{Case: [accusative], Gender: [feminine], Number: [plural]}	a walking, mode of walking
ναυαγίας,	ναυαγία	{Case: [accusative], Gender: [feminine], Number: [plural]}	shipwreck
ἐχροὺς	ἐχρός	{Case: [accusative], Gender: [masculine], Number: [plural]}	
εὐηργέτησαν	εὐεργετέω	{Aspect: [perfective], Mood: [indicative], Number: [plural], Person: [third], Tense: [past], VerbForm: [finite], Voice: [active]}	to do well, do good
αὖ	αὗ	{}	bow wow
καθηῦδον.	καθηῦδονος	{Case: [accusative], Degree: [positive], Gender: [neuter], Number: [singular]}	
2.26.0	2.26.0	{Case: [genitive], Gender: [masculine], Number: [singular]}	
Achilles	Achilles	{Case: [genitive], Degree: [positive], Gender: [masculine], Number: [singular]}	
Agamemnon	Agamemnon	{Case: [genitive], Degree: [positive], Gender: [masculine], Number: [singular]}	
2.26.1	2.26.1	{Case: [genitive], Gender: [masculine], Number: [singular]}	
Δαναοὶ	δαναοὶ	{}	
ἔρις	ἔρις	{Case: [nominative], Gender: [feminine], Number: [singular]}	strife, quarrel, debate, contention
των	των	{Case: [nominative], Gender: [masculine], Number: [singular]}	
ἀνάκτων	ἄνακτος	{Case: [nominative], Degree: [positive], Gender: [masculine], Number: [singular]}	
Ἀχιλλέως.	Ἀχιλλέως.	{Case: [genitive], Gender: [masculine], Number: [singular]}	
στρατοῦ.	στρατοῦς	{Case: [genitive], Gender: [masculine], Number: [singular]}	
Νόμος	Νόμος	{Case: [nominative], Gender: [masculine], Number: [singular]}	
Τροίαν	Τροία	{Case: [accusative], Gender: [feminine], Number: [singular]}	Troy
πέρσαι	πέρσης	{Case: [nominative], Gender: [masculine], Number: [plural]}	
Τρωσίν.	Τρωσίνης	{Case: [dative], Gender: [masculine], Number: [plural]}	
Χρύσην,	Χρύση	{Case: [accusative], Gender: [feminine], Number: [singular]}	Chryse
ἱερέα,	ἱερεύς	{Case: [accusative], Gender: [feminine], Number: [singular]}	a priest, sacrificer
ἐνθένδε	ἐνθένδε	{}	hence, from this quarter
Χρυσηίδα	Χρυσηίς	{Case: [accusative], Gender: [feminine], Number: [singular]}	
λείας	λεῖος	{Case: [genitive], Degree: [positive], Gender: [feminine], Number: [singular]}	smooth, plain, not embroidered
ἔνειμαν	νέμω	{Aspect: [perfective], Mood: [indicative], Number: [plural], Person: [third], Tense: [past], VerbForm: [finite], Voice: [active]}	to deal out, distribute; dwell in (country); pasture (flock)
Ἀγαμέμνονι.	Ἀγαμέμνονι.	{Case: [dative], Gender: [masculine], Number: [singular]}	
2.26.2	2.26.2	{Case: [genitive], Gender: [masculine], Number: [singular]}	
Δαναῶν	Δαναᾶν	{Case: [genitive], Gender: [masculine], Number: [plural]}	
ἀπαιτήσων	ἀπαιτέω	{Case: [nominative], Gender: [masculine], Number: [singular], Tense: [future], VerbForm: [participle], Voice: [active]}	to demand back, demand
ἀκτὴν	ἀκτή	{Case: [accusative], Gender: [feminine], Number: [singular]}	headland, foreland, promontory
ηὔχετο	ηὔχομαι	{Aspect: [imperfective], Mood: [indicative], Number: [singular], Person: [third], Tense: [past], VerbForm: [finite], Voice: [middle]}	
χαλεπῶς	χαλεπῶς	{Degree: [positive]}	with difficulty
τοξεύμασιν.	τοξεύμασις	{Case: [dative], Gender: [neuter], Number: [plural]}	
χαλεπαίνει	χαλεπαίνω	{Mood: [indicative], Number: [singular], Person: [third], Tense: [present], VerbForm: [finite], Voice: [active]}	to be severe, sore, grievous
«Χαλεπαίνει	«Χαλεπαίνει	{Mood: [indicative], Number: [singular], Person: [third], Tense: [present], VerbForm: [finite], Voice: [active]}	
δεῦρο	δεῦρο	{}	hither
ἄπρακτος	ἄπρακτος	{Case: [nominative], Degree: [positive], Gender: [masculine], Number: [singular]}	doing nothing, ineffectual, unprofitable
2.26.3	2.26.3	{Case: [genitive], Gender: [masculine], Number: [singular]}	
«Κακόμαντις	«Κακόμαντις	{Case: [nominative], Gender: [masculine], Number: [singular]}	
οὐδέποτε	οὐδέποτε	{Polarity: [neg]}	never
προφητεύεις.	προφητεύω	{Mood: [indicative], Number: [singular], Person: [second], Tense: [present], VerbForm: [finite], Voice: [active]}	to be an interpreter
νύμφην·	νύμφην	{Case: [accusative], Gender: [feminine], Number: [singular]}	
ἀπολίπητε	ἀπολείπω	{Aspect: [perfective], Mood: [subjunctive], Number: [plural], Person: [second], Tense: [past], VerbForm: [finite], Voice: [active]}	to leave over
ἐμέ,	ἐμέ,	{}	
ἄνακτα,	ἄνακτα	{Case: [accusative], Gender: [masculine], Number: [singular]}	
ἄκληρον	ἄκληρος	{Case: [accusative], Degree: [positive], Gender: [masculine], Number: [singular]}	without lot
.»	.ῆ	{Case: [genitive], Gender: [feminine], Number: [singular]}	
2.26.4	2.26.4	{Case: [genitive], Gender: [masculine], Number: [singular]}	
«Λίαν,»	«Λίαν,»	{Case: [accusative], Gender: [feminine], Number: [singular]}	
«φιλοκερδεῖς,	«φιλοκερδεῖς,	{Case: [accusative], Degree: [positive], Gender: [feminine], Number: [plural]}	
.»	.»	{}	
2.26.5	2.26.5	{Case: [genitive], Gender: [masculine], Number: [singular]}	
Αγαμέμνων	Αγαμέμνων	{Case: [nominative], Gender: [masculine], Number: [singular]}	
μαινόμενος	μαίνομαι	{Case: [nominative], Gender: [masculine], Number: [singular], Tense: [present], VerbForm: [participle], Voice: [middle]}	to rage, be furious
ξίφος·	ξίφος·	{Case: [accusative], Gender: [neuter], Number: [singular]}	
τριχὸς	θρίξ	{Case: [genitive], Gender: [feminine], Number: [singular]}	the hair of the head
κατέχει.	καταχέω	{Mood: [indicative], Number: [singular], Person: [third], Tense: [present], VerbForm: [finite], Voice: [active]}	to pour down upon, pour over
Θαυμάζων	Θαυμάζω	{Case: [nominative], Gender: [masculine], Number: [singular], Tense: [present], VerbForm: [participle], Voice: [active]}	
2.27.0	2.27.0	{Case: [genitive], Gender: [masculine], Number: [singular]}	
Rhesus	Rhesus	{Case: [genitive], Degree: [positive], Gender: [masculine], Number: [singular]}	
2.27.1	2.27.1	{Case: [genitive], Gender: [masculine], Number: [singular]}	
Τρωσὶ	Τρωΐ	{Case: [dative], Gender: [masculine], Number: [plural]}	
Θρᾷκες,	Θρᾶξ	{Case: [nominative], Gender: [masculine], Number: [plural]}	
Ῥῆσος	Ῥῆσος	{Case: [nominative], Gender: [feminine], Number: [singular]}	Rhesus
ἦν.	ἦνειμι	{Aspect: [perfective], Mood: [indicative], Number: [singular], Person: [third], Tense: [past], VerbForm: [finite], Voice: [active]}	
θάσσους	θάσσος	{Case: [accusative], Degree: [positive], Gender: [masculine], Number: [plural]}	
ἄλλων.	ἄλλων	{Case: [genitive], Degree: [positive], Gender: [masculine], Number: [plural]}	
Χρησμολόγος	Χρησμολόγος	{Case: [nominative], Gender: [masculine], Number: [singular]}	
Τροιάν	Τροιάς	{Case: [accusative], Gender: [feminine], Number: [singular]}	
Ξάνθου	Ξάνθος	{Case: [genitive], Gender: [feminine], Number: [singular]}	Xanthus (m. of persons and rivers; f. of town)
ξυμπολεμεῖν.	ξυμπολεῖνω	{Tense: [present], VerbForm: [infinitive], Voice: [active]}	
χρησμολόγος	χρησμολόγος	{Case: [nominative], Degree: [positive], Gender: [masculine], Number: [singular]}	uttering oracles, divining
Βουλῆς	Βουλή	{Case: [genitive], Gender: [feminine], Number: [singular]}	
ἄναξ	ἄναξ	{Case: [nominative], Gender: [masculine], Number: [singular]}	a lord, master
ἔλεξεν.	ἔλλω	{Aspect: [perfective], Mood: [indicative], Number: [singular], Person: [third], Tense: [past], VerbForm: [finite], Voice: [active]}	
2.27.2	2.27.2	{Case: [genitive], Gender: [masculine], Number: [singular]}	
Θρᾳκῶν;	Θρακών	{Case: [genitive], Gender: [masculine], Number: [plural]}	
Μέγας	Μέγας	{Case: [nominative], Degree: [positive], Gender: [masculine], Number: [singular]}	
μέν	μέν	{}	on the one hand, on the other hand
κίνδυνος,	κίνδυνος,	{Case: [nominative], Gender: [masculine], Number: [singular]}	
κλέος	κλέος	{Case: [nominative], Gender: [neuter], Number: [singular]}	a rumour, report; fame, glory
εὐτυχοῦντι.	εὐτυχούνω	{Case: [dative], Gender: [masculine], Number: [singular], Tense: [present], VerbForm: [participle], Voice: [active]}	
πολυτελῆ	πολυτελής	{Case: [accusative], Degree: [positive], Gender: [neuter], Number: [plural]}	very expensive, very costly
ἐνθάδε	ἐνθάδε	{}	here, in this place, at this point
2.27.3	2.27.3	{Case: [genitive], Gender: [masculine], Number: [singular]}	
ἀντεῖπε	ἀντέπω	{Aspect: [perfective], Mood: [indicative], Number: [singular], Person: [third], Tense: [past], VerbForm: [finite], Voice: [active]}	
Θρᾳκῶν	Θρᾷξ	{Case: [genitive], Gender: [masculine], Number: [plural]}	a Thracian
σκηνὰς	σκηνή	{Case: [accusative], Gender: [feminine], Number: [plural]}	a covered place, a tent
ἐνδόξους	ἐνδόξοος	{Case: [accusative], Degree: [positive], Gender: [masculine], Number: [plural]}	
ξυμπορεύσηταί	ξυμπορεύομαι	{Aspect: [perfective], Mood: [subjunctive], Number: [singular], Person: [third], Tense: [past], VerbForm: [finite], Voice: [middle]}	
μοι.	μοι.	{}	
ὅντα	ὅντα	{}	
ξυνκινδυνεύειν	ξυνκινδυνεύω	{Tense: [present], VerbForm: [infinitive], Voice: [active]}	
Διομήδει.	Διομήδεια	{Case: [dative], Gender: [masculine], Number: [singular]}	absolute, dire
2.27.4	2.27.4	{Case: [genitive], Gender: [masculine], Number: [singular]}	
ὡπλισμένος	ὁπλίζω	{Aspect: [perfective], Case: [nominative], Gender: [masculine], Number: [singular], Tense: [past], VerbForm: [participle], Voice: [passive]}	to equip, make ready; to arm
σκηνήν.	σκηνήν	{Case: [accusative], Gender: [feminine], Number: [singular]}	
φρουροὺς	φρουρός	{Case: [accusative], Degree: [positive], Gender: [masculine], Number: [plural]}	a watcher, guard
ξυλλαβὼν	ξυλλαβάω	{Aspect: [perfective], Case: [nominative], Gender: [masculine], Number: [singular], Tense: [past], VerbForm: [participle], Voice: [active]}	
ἔξω,	ἔξω,	{}	
φίλον.	φίλον	{Case: [accusative], Gender: [masculine], Number: [singular]}	
τρισκαιδέκατον	τρισκαίδεκος	{Case: [accusative], Gender: [masculine], Number: [singular]}	
2.28.0	2.28.0	{Case: [genitive], Gender: [masculine], Number: [singular]}	
Syracuse	Syracuse	{Case: [genitive], Degree: [positive], Gender: [masculine], Number: [singular]}	
2.28.1	2.28.1	{Case: [genitive], Gender: [masculine], Number: [singular]}	
Συράκουσαι	Συράκουσαι	{Case: [nominative], Gender: [feminine], Number: [plural]}	Syracuse
Κορινθίων	Κορίνθιος	{Case: [genitive], Degree: [positive], Gender: [masculine], Number: [plural]}	Corinthian
ᾠκίσθησαν	οἰκίζω	{Aspect: [perfective], Mood: [indicative], Number: [plural], Person: [third], Tense: [past], VerbForm: [finite], Voice: [passive]}	to found as a colony
ἄλλοθεν·	ἄλλοθεν·	{}	
Ἐγεσταῖοι	Ἐγεσταῖος	{Case: [nominative], Degree: [positive], Gender: [masculine], Number: [plural]}	of Segesta (Sicily)
Συρακόσιοι,	Συρακόσιος	{Case: [nominative], Degree: [positive], Gender: [masculine], Number: [plural]}	Syracusan
ἀπέστειλαν	ἀποστέλλω	{Aspect: [perfective], Mood: [indicative], Number: [plural], Person: [third], Tense: [past], VerbForm: [finite], Voice: [active]}	to send off
ἐπιβοηθεῖν.	ἐπιβοηθείω	{Aspect: [perfective], Tense: [past], VerbForm: [infinitive], Voice: [active]}	
ἐπεβοήθησαν	ἐπιβοηθέω	{Aspect: [perfective], Mood: [indicative], Number: [plural], Person: [third], Tense: [past], VerbForm: [finite], Voice: [active]}	to come to aid, to succour
Συρακοσίοις.	Συρακούσιος	{Case: [dative], Degree: [positive], Gender: [masculine], Number: [plural]}	
ξυνεχὴς	ξυνεχής	{Case: [nominative], Degree: [positive], Gender: [masculine], Number: [singular]}	
οἷκον	οἷκος	{Case: [accusative], Degree: [positive], Gender: [neuter], Number: [singular]}	
2.28.2	2.28.2	{Case: [genitive], Gender: [masculine], Number: [singular]}	
ξυμπολεμεῖν,	ξυμπολεῖδω	{Tense: [present], VerbForm: [infinitive], Voice: [active]}	
ἄπειροι	ἄπειρος	{Case: [nominative], Degree: [positive], Gender: [masculine], Number: [plural]}	without trial, inexperienced
ἐψηφίσαντο	ψηφίζω	{Aspect: [perfective], Mood: [indicative], Number: [plural], Person: [third], Tense: [past], VerbForm: [finite], Voice: [middle]}	(mid.) to vote; (act.) to count with pebbles
στρατείαν.	στρατείαν	{Case: [accusative], Gender: [feminine], Number: [singular]}	
στρατεία	στρατεία	{Case: [nominative], Gender: [feminine], Number: [singular]}	an expedition, campaign
ἀκοντισταῖς	ἀκοντιστής	{Case: [dative], Gender: [masculine], Number: [plural]}	a darter, javelin-man
σφενδονήταις.	σφενδονήτης	{Case: [dative], Gender: [masculine], Number: [plural]}	a slinger
ηὐτύχουν.	εὐτυχουνέω	{Aspect: [imperfective], Mood: [indicative], Number: [plural], Person: [third], Tense: [past], VerbForm: [finite], Voice: [active]}	
μετεπέμψατο	μεταπέμπω	{Aspect: [perfective], Mood: [indicative], Number: [singular], Person: [third], Tense: [past], VerbForm: [finite], Voice: [middle]}	to send after
Νικίας	Νικία	{Case: [genitive], Gender: [feminine], Number: [singular]}	
ξυνέλεξαν	ξυλέω	{Aspect: [perfective], Mood: [indicative], Number: [plural], Person: [third], Tense: [past], VerbForm: [finite], Voice: [active]}	
ὀπλίτας	ὀπλίτης	{Case: [accusative], Gender: [masculine], Number: [plural]}	
Σικελίαν.	Σικελίαν	{Case: [accusative], Gender: [feminine], Number: [singular]}	
2.28.3	2.28.3	{Case: [genitive], Gender: [masculine], Number: [singular]}	
τείχισμα	τείχισμα	{Case: [nominative], Gender: [neuter], Number: [singular]}	a wall
Συρακουσῶν	Συρακουσής	{Case: [genitive], Gender: [masculine], Number: [plural]}	
οὐδαμῶς	οὐδαμῶς	{Polarity: [neg]}	in no wise
μεσογείαν,	μεσόγεια	{Case: [accusative], Gender: [feminine], Number: [singular]}	
διέφευγον.	διαφεύγω	{Aspect: [imperfective], Mood: [indicative], Number: [plural], Person: [third], Tense: [past], VerbForm: [finite], Voice: [active]}	to flee through, get away from, escape
Ἐδούλωσαν	δουλόω	{Aspect: [perfective], Mood: [indicative], Number: [plural], Person: [third], Tense: [past], VerbForm: [finite], Voice: [active]}	to make a slave of, enslave
ξυλληφθέντας	ξυλλάπω	{Aspect: [perfective], Case: [accusative], Gender: [masculine], Number: [plural], Tense: [past], VerbForm: [participle], Voice: [passive]}	
ἑπτακισχιλίους,	ἑπτακισχίλιοι	{Case: [accusative], Gender: [masculine], Number: [plural]}	seven-thousand
Δημοσθένην	Δημοσθένη	{Case: [accusative], Gender: [masculine], Number: [singular]}	
ἀπέσφαξαν.	ἀποσφάσσω	{Aspect: [perfective], Mood: [indicative], Number: [plural], Person: [third], Tense: [past], VerbForm: [finite], Voice: [active]}	
2.29.0	2.29.0	{Case: [genitive], Gender: [masculine], Number: [singular]}	
Alcibiades	Alcibiades	{Case: [nominative], Degree: [positive], Gender: [masculine], Number: [singular]}	
2.29.1	2.29.1	{Case: [genitive], Gender: [masculine], Number: [singular]}	
Κλεινίου	Κλείνιον	{Case: [genitive], Gender: [masculine], Number: [singular]}	
κάλλιστος	καλλίστος	{Case: [nominative], Degree: [superlative], Gender: [masculine], Number: [singular]}	
ἀκόλαστος	ἀκόλαστος	{Case: [nominative], Degree: [positive], Gender: [masculine], Number: [singular]}	licentious, intemperate
ἀσεβής.	ἀσεβής	{Case: [nominative], Degree: [positive], Gender: [masculine], Number: [singular]}	ungodly, godless, unholy, profane
φιλόσοφος,	φιλόσοφος	{Case: [nominative], Degree: [positive], Gender: [masculine], Number: [singular]}	a lover of wisdom
ἀκολασίας.	ἀκολασία	{Case: [genitive], Gender: [feminine], Number: [singular]}	licentiousness, intemperance
Ἀλκιβιάδης,	Ἀλκιβιάδης,	{Case: [nominative], Gender: [masculine], Number: [singular]}	
μειράκιον	μειράκιον	{Case: [accusative], Gender: [neuter], Number: [singular]}	a boy, lad, stripling
Ποτίδαιαν	Ποτίδαια	{Case: [accusative], Gender: [feminine], Number: [singular]}	
Σωκράτη	Σωκράτη	{Case: [accusative], Gender: [masculine], Number: [singular]}	
ξύσκηνόν	ξύσκηνος	{Case: [accusative], Degree: [positive], Gender: [masculine], Number: [singular]}	
παραστάτην	παραστάτης	{Case: [accusative], Gender: [masculine], Number: [singular]}	one who stands by, a defender
Ἀλκιβίαδου	Ἀλκίβιαδος	{Case: [genitive], Gender: [masculine], Number: [singular]}	
Δηλίῳ	Δηλίον	{Case: [dative], Gender: [masculine], Number: [singular]}	
Σωκράτους	Σώκρατος	{Case: [accusative], Gender: [masculine], Number: [plural]}	
πεζῇ	πεζῇ	{}	
ἰσχυρῶς	ἰσχυρῶς	{Degree: [positive]}	
ἐπικειμένων.	ἐπικείμνυμι	{Case: [genitive], Gender: [masculine], Number: [plural], Tense: [present], VerbForm: [participle], Voice: [middle]}	
2.29.2	2.29.2	{Case: [genitive], Gender: [masculine], Number: [singular]}	
Ἐνῆγε	ἐνάγω	{Aspect: [imperfective], Mood: [indicative], Number: [singular], Person: [third], Tense: [past], VerbForm: [finite], Voice: [active]}	to lead in
προθυμότατα	πρόθυμος	{Case: [accusative], Degree: [superlative], Gender: [neuter], Number: [plural]}	ready, willing, eager, zealous
στρατηγῆσαί	στρατηγέω	{Aspect: [perfective], Tense: [past], VerbForm: [infinitive], Voice: [active]}	to be general
στρατείας.	στράτεια	{Case: [genitive], Gender: [feminine], Number: [singular]}	
μετανοήσαντες	μετανοέω	{Aspect: [perfective], Case: [nominative], Gender: [masculine], Number: [plural], Tense: [past], VerbForm: [participle], Voice: [active]}	to change one's mind
Σαλαμινίαν	Σαλαμινία	{Case: [accusative], Degree: [positive], Gender: [feminine], Number: [singular]}	
ἀνοίσουσαν.	ἀναισουσαμέω	{Case: [accusative], Gender: [feminine], Number: [singular], Tense: [present], VerbForm: [participle], Voice: [active]}	
λιθίνων	λίθινος	{Case: [genitive], Degree: [positive], Gender: [masculine], Number: [plural]}	of stone
Ἑρμῶν	Ἑρμᾶς	{Case: [nominative], Gender: [masculine], Number: [singular]}	
περιέκοψεν.	περικοψεναίνω	{Aspect: [perfective], Mood: [indicative], Number: [singular], Person: [third], Tense: [past], VerbForm: [finite], Voice: [active]}	
(Πολλοὶ	εφολλός	{Case: [nominative], Degree: [positive], Gender: [masculine], Number: [plural]}	
Ἑρμαῖ	Ἑρμαῖ	{Case: [dative], Gender: [masculine], Number: [singular]}	
προθύροις	πρόθυρος	{Case: [dative], Gender: [neuter], Number: [plural]}	
περιεκόπησαν	περικοπέω	{Aspect: [perfective], Mood: [indicative], Number: [plural], Person: [third], Tense: [past], VerbForm: [finite], Voice: [active]}	
πρόσωπα.)	πρόσωπα	{Case: [accusative], Gender: [neuter], Number: [plural]}	
Σαλαμινία	Σαλαμινίος	{Case: [nominative], Degree: [positive], Gender: [feminine], Number: [singular]}	
Θουρίοις	Θούριος	{Case: [dative], Degree: [positive], Gender: [masculine], Number: [plural]}	(adj.) of Thurii, (n.pl.) the city of Thurii
πλοίου	πλοῖον	{Case: [genitive], Gender: [neuter], Number: [singular]}	a floating vessel, a ship, vessel
ἐρήμῃ	ἐρήμη	{Case: [dative], Gender: [feminine], Number: [singular]}	
κατέγνωσαν	καταγιγνώσκω	{Aspect: [perfective], Mood: [indicative], Number: [plural], Person: [third], Tense: [past], VerbForm: [finite], Voice: [active]}	to remark, discover
2.29.3	2.29.3	{Case: [genitive], Gender: [masculine], Number: [singular]}	
φιλανθρώπως	φιλανθρώπως	{Degree: [positive]}	
δεδεγμένος	δέρω	{Aspect: [perfective], Case: [nominative], Gender: [masculine], Number: [singular], Tense: [past], VerbForm: [participle], Voice: [passive]}	to skin, flay
τειχίσαι	τειχίζω	{Aspect: [perfective], Tense: [past], VerbForm: [infinitive], Voice: [active]}	to build a wall
Δεκέλειαν	Δεκέλεια	{Case: [accusative], Gender: [feminine], Number: [singular]}	Deceleia
Ἀττικῆς,	Ἀττικός	{Case: [genitive], Degree: [positive], Gender: [feminine], Number: [singular]}	Attic, Athenian
βεβαιότατα	βέβαιος	{Case: [nominative], Degree: [superlative], Gender: [neuter], Number: [plural]}	firm, steady, steadfast, sure, certain
βλάπτειν.	βλάπτω	{Tense: [present], VerbForm: [infinitive], Voice: [active]}	to disable, hinder (Hom.); to harm, damage
2.30.0	2.30.0	{Case: [genitive], Gender: [masculine], Number: [singular]}	
Philoctetes	Philoctetes	{Case: [genitive], Degree: [positive], Gender: [masculine], Number: [singular]}	
2.30.1	2.30.1	{Case: [genitive], Gender: [masculine], Number: [singular]}	
Φιλοκτήτης	Φιλοκτήτης	{Case: [genitive], Gender: [feminine], Number: [singular]}	Philoctetes
Ποίαντος	Ποίαντος	{Case: [genitive], Gender: [masculine], Number: [singular]}	
Ἡρακλέους.	Ἡρακλέους.	{Case: [genitive], Gender: [masculine], Number: [singular]}	
ὅπλων,	ὅπλων	{Case: [genitive], Gender: [neuter], Number: [plural]}	
ἐκάθιζεν	καθίζω	{Aspect: [imperfective], Mood: [indicative], Number: [singular], Person: [third], Tense: [past], VerbForm: [finite], Voice: [active]}	to make to sit down, seat
Ὕλλον	Ὕλλος	{Case: [accusative], Gender: [masculine], Number: [singular]}	Hyllus
ἅψαι.	ἅψτω	{Aspect: [perfective], Tense: [past], VerbForm: [infinitive], Voice: [active]}	
κατακαυθῂ,	κατακαίω	{Aspect: [perfective], Mood: [indicative], Number: [singular], Person: [third], Tense: [past], VerbForm: [finite], Voice: [active]}	to burn down, burn completely
Ἠρακλῆς	Ἠρακλῆς	{Case: [genitive], Gender: [feminine], Number: [singular]}	
Φιλοκτήτου	Φιλοκτῆτης	{Case: [genitive], Gender: [masculine], Number: [singular]}	
2.30.2	2.30.2	{Case: [genitive], Gender: [masculine], Number: [singular]}	
στόλος	στόλος	{Case: [nominative], Gender: [masculine], Number: [singular]}	an expedition; a voyage; equipment
καθωρμίσθη	καθόρχομαι	{Aspect: [perfective], Mood: [indicative], Number: [singular], Person: [third], Tense: [past], VerbForm: [finite], Voice: [passive]}	
βωμοῦ	βωμός	{Case: [genitive], Gender: [masculine], Number: [singular]}	any raised platform, a stand
ἔδακεν.	δακέω	{Aspect: [perfective], Mood: [indicative], Number: [singular], Person: [third], Tense: [past], VerbForm: [finite], Voice: [active]}	
Λῆμνον	Λῆμνος	{Case: [accusative], Gender: [feminine], Number: [singular]}	Lemnos
ἐνταῦθα,	ἐνταῦθης	{Case: [accusative], Gender: [neuter], Number: [plural]}	
Τροίαν.	Τροίανα	{Case: [accusative], Gender: [feminine], Number: [singular]}	
πέρσουσιν	πέρνημι	{Mood: [indicative], Number: [plural], Person: [third], Tense: [future], VerbForm: [finite], Voice: [active]}	to export for sale, to sell
Ἡρακλεόυς	Ἡράκλεια	{Case: [genitive], Gender: [masculine], Number: [singular]}	Heraclea (name of various towns)
2.30.3	2.30.3	{Case: [genitive], Gender: [masculine], Number: [singular]}	
Νεοπτόλεμον	Νεοπτόλεμος	{Case: [accusative], Gender: [masculine], Number: [singular]}	Neoptolemus, ‘new-warrior’
Φιλοκτήτην.	Φιλοκτήτην	{Case: [accusative], Gender: [feminine], Number: [singular]}	
Ηὗρον	Ηὗρον	{Case: [accusative], Gender: [masculine], Number: [singular]}	
λελοίπασιν.	λελοίπασις	{Case: [dative], Gender: [masculine], Number: [plural]}	
ἱέναι.	ἱεναίνω	{Tense: [present], VerbForm: [infinitive], Voice: [active]}	
δυστυχὴς	δυστυχή	{Case: [nominative], Gender: [feminine], Number: [singular]}	
ἐλιποψύχει	ἐλιποψύχομαι	{Aspect: [imperfective], Mood: [indicative], Number: [singular], Person: [third], Tense: [past], VerbForm: [finite], Voice: [active]}	
λύπην,	λύπην	{Case: [accusative], Gender: [feminine], Number: [singular]}	
Φιλοκτήτης,	Φιλοκτήτης,	{Case: [genitive], Gender: [feminine], Number: [singular]}	
στερηθῇ	στερέω	{Aspect: [perfective], Mood: [subjunctive], Number: [singular], Person: [third], Tense: [past], VerbForm: [finite], Voice: [passive]}	to deprive, bereave, rob of
ἄκων	ἄκων	{Case: [nominative], Degree: [positive], Gender: [masculine], Number: [singular]}	a javelin, dart
ἕσπετο	ἕσπω	{Aspect: [perfective], Mood: [indicative], Number: [singular], Person: [third], Tense: [past], VerbForm: [finite], Voice: [middle]}	
ἐμβὰς	ἐμβαίνω	{Aspect: [perfective], Case: [nominative], Gender: [masculine], Number: [singular], Tense: [past], VerbForm: [participle], Voice: [active]}	to step in
Πριάμου,	Πρίαμα	{Case: [genitive], Gender: [masculine], Number: [singular]}	
2.31.0	2.31.0	{Case: [genitive], Gender: [masculine], Number: [singular]}	
Marathon	Marathon	{Case: [genitive], Degree: [positive], Gender: [masculine], Number: [singular]}	
2.31.1	2.31.1	{Case: [genitive], Gender: [masculine], Number: [singular]}	
ἐπενοοῦντο	πενοέω	{Aspect: [imperfective], Mood: [indicative], Number: [plural], Person: [third], Tense: [past], VerbForm: [finite], Voice: [middle]}	
ἐσβαλεῖν	εἰσβάλλω	{Aspect: [perfective], Tense: [past], VerbForm: [infinitive], Voice: [active]}	to throw into, put into
ζημιοῖεν.	ζημιομέω	{Mood: [optative], Number: [plural], Person: [third], Tense: [present], VerbForm: [finite], Voice: [active]}	
Δάτιδος	Δάτις	{Case: [nominative], Gender: [masculine], Number: [singular]}	
Ἀρταφέρνους	Ἀρτάφερνοι	{Case: [accusative], Gender: [masculine], Number: [plural]}	
Ἱππίας	Ἱππίας	{Case: [nominative], Gender: [masculine], Number: [singular]}	Hippias
τιμωρίαν	τιμωρία	{Case: [accusative], Gender: [feminine], Number: [singular]}	retribution, vengeance
Εὔβοιαν,	Εὔβοια	{Case: [accusative], Gender: [feminine], Number: [singular]}	Euboea
μακρὰν	μακράν	{}	a long way, far, far away; a long time, at length
Ἀττικῇ	Αττική	{Case: [dative], Degree: [positive], Gender: [feminine], Number: [singular]}	
Ἐντεῦθεν	Ἐντεῦθεν	{}	
2.31.2	2.31.2	{Case: [genitive], Gender: [masculine], Number: [singular]}	
Πλαταιέων,	Πλαταιεύς	{Case: [genitive], Gender: [masculine], Number: [plural]}	inhabitant of Plataeae, Plataean
Μιλτιάδῃ	Μιλτιάδης	{Case: [dative], Gender: [masculine], Number: [singular]}	Miltiades
σφαγίων	σφάγιον	{Case: [genitive], Gender: [neuter], Number: [plural]}	a victim, offering
ἵεντο	τίδω	{Aspect: [imperfective], Mood: [indicative], Number: [plural], Person: [third], Tense: [past], VerbForm: [finite], Voice: [middle]}	
ἐναντίων.	ἐναντίων	{Case: [genitive], Degree: [positive], Gender: [masculine], Number: [plural]}	
ἐπειγομένους,	ἐπείγνυμι	{Case: [accusative], Gender: [masculine], Number: [plural], Tense: [present], VerbForm: [participle], Voice: [middle]}	
τοξοτῶν.	τοξοτών	{Case: [genitive], Gender: [masculine], Number: [plural]}	
ἀθρόοι	ἀθρόος	{Case: [nominative], Degree: [positive], Gender: [masculine], Number: [plural]}	in crowds, massed together
ἀξίως	ἀξίως	{Degree: [positive]}	
2.31.3	2.31.3	{Case: [genitive], Gender: [masculine], Number: [singular]}	
ἀσθενὲς	ἀσθενής	{Case: [accusative], Degree: [positive], Gender: [neuter], Number: [singular]}	without strength, weak, feeble, weakly
ἐνίκων,	νικόω	{Aspect: [imperfective], Mood: [indicative], Number: [plural], Person: [third], Tense: [past], VerbForm: [finite], Voice: [active]}	
κέρας	κέρας	{Case: [accusative], Gender: [neuter], Number: [singular]}	the horn of an animal
ἐνίκων.	ἐνοκώνω	{Aspect: [imperfective], Mood: [indicative], Number: [plural], Person: [third], Tense: [past], VerbForm: [finite], Voice: [active]}	
ξυναγαγόντες	ξυνάγω	{Aspect: [perfective], Case: [nominative], Gender: [masculine], Number: [plural], Tense: [past], VerbForm: [participle], Voice: [active]}	
διέρρηξαν	διερρρήγνυμι	{Aspect: [perfective], Mood: [indicative], Number: [plural], Person: [third], Tense: [past], VerbForm: [finite], Voice: [active]}	
ἥκειν.	ἥκειμι	{Tense: [present], VerbForm: [infinitive], Voice: [active]}	
ἑξακισχίλιοι	ἑξακισχίλιοι	{Case: [nominative], Gender: [masculine], Number: [plural]}	six thousand
τετρακόσιοι,	τετρακόσιοι	{Case: [nominative], Gender: [masculine], Number: [plural]}	four hundred
ἐνενήκοντα	ἐνενήκοντα	{}	ninety
2.32.0	2.32.0	{Case: [genitive], Gender: [masculine], Number: [singular]}	
Salamis	Salamis	{Case: [genitive], Degree: [positive], Gender: [masculine], Number: [singular]}	
2.32.1	2.32.1	{Case: [genitive], Gender: [masculine], Number: [singular]}	
Μήδων	Μῆδος	{Case: [genitive], Gender: [masculine], Number: [plural]}	a Mede, Median
ἐνέπρησε	ἐμπίμπρημι	{Aspect: [perfective], Mood: [indicative], Number: [singular], Person: [third], Tense: [past], VerbForm: [finite], Voice: [active]}	to kindle, burn, set on fire
αἰσθόμενοι	αἰστόω	{Case: [nominative], Gender: [masculine], Number: [plural], Tense: [present], VerbForm: [participle], Voice: [middle]}	
ἐσέβησαν,	εἰσβαίνω	{Aspect: [perfective], Mood: [indicative], Number: [plural], Person: [third], Tense: [past], VerbForm: [finite], Voice: [active]}	to go into
ἀπομάχοιντο.	ἀπομάχομαι	{Mood: [optative], Number: [plural], Person: [third], Tense: [present], VerbForm: [finite], Voice: [middle]}	to fight from
ἔσεσθαι.	εἰσθαίθω	{Tense: [future], VerbForm: [infinitive], Voice: [middle]}	
κόλπῳ	κόλπος	{Case: [dative], Gender: [masculine], Number: [singular]}	bosom; gulf
ναυμαχίαν	ναυμαχία	{Case: [accusative], Gender: [feminine], Number: [singular]}	a sea-fight
ὀγδοήκοντα	ὀγδοήκοντα	{}	eighty
τριακοσίας	τριακόσιοι	{Case: [accusative], Gender: [feminine], Number: [plural]}	three hundred
2.32.2	2.32.2	{Case: [genitive], Gender: [masculine], Number: [singular]}	
Ξέρξης,	Ξέρξης,	{Case: [nominative], Gender: [masculine], Number: [singular]}	
γραμματεάς	γραμματεύς	{Case: [accusative], Gender: [masculine], Number: [plural]}	a secretary, clerk
ἐκαθέζετο	καθέζομαι	{Aspect: [imperfective], Mood: [indicative], Number: [singular], Person: [third], Tense: [past], VerbForm: [finite], Voice: [middle]}	to sit down, take one's seat
θρόνῳ	θρόνος	{Case: [dative], Gender: [masculine], Number: [singular]}	a seat, chair
κρημνῷ	κρημνός	{Case: [dative], Gender: [masculine], Number: [singular]}	an overhanging bank
ὑπερέχοντι.	ὑπορρχοντίζω	{Case: [dative], Gender: [masculine], Number: [singular], Tense: [present], VerbForm: [participle], Voice: [active]}	
ἀνεκρούοντο	ἀνακρούω	{Aspect: [imperfective], Mood: [indicative], Number: [plural], Person: [third], Tense: [past], VerbForm: [finite], Voice: [middle]}	to push back, stop short, check
λιπόντες,	λιπόω	{Aspect: [perfective], Case: [nominative], Gender: [masculine], Number: [plural], Tense: [past], VerbForm: [participle], Voice: [active]}	
διακόσιαι	διακόσιοι	{Case: [nominative], Gender: [feminine], Number: [plural]}	two hundred
ὀκείλασαι	ὀκείλω	{Aspect: [perfective], Mood: [indicative], Number: [singular], Person: [second], Tense: [past], VerbForm: [finite], Voice: [middle]}	
Ἑλληνικῶν	Ἑλληνικός	{Case: [genitive], Degree: [positive], Gender: [masculine], Number: [plural]}	Hellenic, Greek
ἐμβόλοις	ἔμβολος	{Case: [dative], Gender: [masculine], Number: [plural]}	pointed so as to be thrust in: ram, peg, bolt
ῥαγεῖσαι.	ῥαγείδω	{Aspect: [perfective], Case: [nominative], Gender: [feminine], Number: [plural], Tense: [past], VerbForm: [participle], Voice: [passive]}	
ἐπιβατῶν	ἐπιβάτης	{Case: [genitive], Gender: [masculine], Number: [plural]}	one who mounts
ἐπιστάμενοι	ἐπίσταμαι	{Case: [nominative], Gender: [masculine], Number: [plural], Tense: [present], VerbForm: [participle], Voice: [middle]}	to know
2.32.3	2.32.3	{Case: [genitive], Gender: [masculine], Number: [singular]}	
λιμῷ	λιμός	{Case: [dative], Gender: [masculine], Number: [singular]}	hunger, famine
ἐπειγόμενον,	ἐπείγομαι	{Case: [accusative], Gender: [masculine], Number: [plural], Tense: [present], VerbForm: [participle], Voice: [middle]}	
διεβίβασεν	διαβιβάζω	{Aspect: [perfective], Mood: [indicative], Number: [singular], Person: [third], Tense: [past], VerbForm: [finite], Voice: [active]}	to carry over
Ἄβυδον,	Ἄβυδος	{Case: [accusative], Gender: [feminine], Number: [singular]}	Abydos
ἔνθεν	ἔνθεν	{}	whence; thence
