1.1.1			
Ἀθήνης	Αθῆνη	Case: genitive, Gender: feminine, Number: singular	Athena
Ἀθήνη	Ἀθῆναι	Case: nominative, Gender: feminine, Number: singular	the city of Athens
Ἀθηναίων	Ἀθηναῖος	Case: genitive, Degree: positive, Gender: masculine, Number: plural	Athenian, Athenian citizen
Διὸς	Ζεύς	Case: genitive, Gender: masculine, Number: singular	Zeus
μαρμάρινον	μαρμάρινος	Case: nominative, Degree: positive, Gender: neuter, Number: singular	made of marble
Πεντελικὸν	Πεντελικός	Case: nominative, Degree: positive, Gender: neuter, Number: singular	Mt Pentele or Pentelicon
πορίζει	πορίζω	Mood: indicative, Number: singular, Person: third, Tense: present, VerbForm: finite, Voice: active	to provide, supply
λεύκοί	λεύκος	Case: nominative, Degree: positive, Gender: masculine, Number: plural	white
λιθοτομίαι	λιθοτομία	Case: nominative, Gender: feminine, Number: plural	a quarry
Ἕλλησιν	Ἕλλην	Case: dative, Gender: masculine, Number: plural	a Greek
κωμῳδίας	κωμῳδία	Case: accusative, Gender: feminine, Number: plural	a comedy
τραγῳδίας	τραγῳδία	Case: accusative, Gender: feminine, Number: plural	a tragedy
Σοφοκλῆς	Σοφοκλῆς	Case: nominative, Gender: masculine, Number: singular	Sophocles
Ἀριστοφάνης	Ἀριστοφάνης	Case: nominative, Gender: masculine, Number: singular	Aristophanes
εὔδοξος	εὔδοξος	Case: nominative, Gender: masculine, Number: singular	of good repute, honoured, famous, glorious
Πλούσιός	Πλούσιος	Case: nominative, Gender: masculine, Number: singular	
ἐχορήγει	ἐχορήγω	Aspect: imperfective, Mood: indicative, Number: singular, Person: third, Tense: past, VerbForm: finite, Voice: active	
πολῖται	πολίτης	Case: nominative, Gender: masculine, Number: plural	(fellow) citizen
ἀθρόοι	ἀθρόος	Case: nominative, Degree: positive, Gender: masculine, Number: plural	in crowds, massed together
ἐφοίτων	φοιτάω	Aspect: imperfective, Mood: indicative, Number: plural, Person: third, Tense: past, VerbForm: finite, Voice: active	to go to and fro, up and down, to stalk
θέατρον	θέατρων	Case: accusative, Gender: neuter, Number: singular	
ὑποκριταί	ὑποκριταία	Case: nominative, Gender: masculine, Number: plural	
ὑποκριταὶ	ὑποκριτής	Case: nominative, Gender: masculine, Number: plural	an interpreter, actor
ἐφόρουν	φορούνω	Aspect: imperfective, Mood: indicative, Number: plural, Person: third, Tense: past, VerbForm: finite, Voice: active	
παντοῖα	παντοῖος	Case: nominative, Degree: positive, Gender: neuter, Number: plural	of all sorts
θαυμάσια	θαυμάσιος	Case: nominative, Degree: positive, Gender: neuter, Number: plural	wondrous, wonderful, marvellous
Arms	Arms	Case: genitive, Degree: positive, Gender: masculine, Number: singular	
ὁπλίτης	ὁπλίτης	Case: nominative, Gender: masculine, Number: singular	heavy-armed, armed
κνημῖδες	κνημίς	Case: nominative, Gender: feminine, Number: plural	a greave
κνήμας	κνῆμα	Case: accusative, Gender: feminine, Number: plural	
Χαλξοῦς	Χαλξοῦς	Case: genitive, Gender: feminine, Number: singular	
θώραξ	θώραξ	Case: nominative, Gender: feminine, Number: singular	a breastplate, cuirass, corslet
στέρνον	στέρνον	Case: accusative, Gender: neuter, Number: singular	the breast, chest
κράνος	κράνος	Case: accusative, Gender: neuter, Number: singular	a helmet
χαλκοῦν	χαλκός	Case: accusative, Gender: masculine, Number: singular	copper
Ἵππιοι	Ἵππιον	Case: nominative, Gender: masculine, Number: plural	
λόφοι	λόφος	Case: nominative, Gender: masculine, Number: plural	neck, crest of hill, ridge, crest of a helmet
ἐπινεύουσιν	ἐπινεύω	Mood: indicative, Number: plural, Person: third, Tense: present, VerbForm: finite, Voice: active	to nod
κράνει	κράνεια	Case: dative, Gender: neuter, Number: singular	the cornel-tree, dog-wood
ἀριστερὰ	ἀριστερός	Case: accusative, Degree: positive, Gender: neuter, Number: plural	left, on the left
ἀσπίδα	ἀσπίδης	Case: accusative, Gender: feminine, Number: singular	
δόρατα	δόρυ	Case: accusative, Gender: neuter, Number: plural	tree, plank, spear
Ζωστήρ	Ζωστήρ	Case: nominative, Gender: masculine, Number: singular	
σκύτινος	σκύτινος	Case: nominative, Degree: positive, Gender: masculine, Number: singular	leathern, made of leather
ἀνείχει	ἀνέχω	Aspect: imperfective, Mood: indicative, Number: singular, Person: third, Tense: past, VerbForm: finite, Voice: active	to hold up; (mid.) endure, put up with
ξίφος	ξίφος	Case: accusative, Gender: neuter, Number: singular	a sword
ἐστιν	ἔστινον	Case: vocative, Gender: masculine, Number: singular	
Torch-race	Torch-race	Case: genitive, Degree: positive, Gender: masculine, Number: singular	
1.4.1	1.4.1	Case: genitive, Gender: masculine, Number: singular	
ἐθεράπευον	θεραπεύω	Aspect: imperfective, Mood: indicative, Number: plural, Person: third, Tense: past, VerbForm: finite, Voice: active	to be an attendant, do service
1.4.2	1.4.2		
Προμηθεία	προμηθεία	Case: nominative, Gender: feminine, Number: singular	
1.4.3	1.4.3	Case: accusative, Gender: masculine, Number: singular	
Ἄρτεμις	Ἄρτεμις	Case: nominative, Gender: feminine, Number: singular	Artemis
σεμηνὴ	σεμηνός	Case: nominative, Degree: positive, Gender: feminine, Number: singular	
1.4.4	1.4.4	Case: nominative, Gender: feminine, Number: singular	
ἐνιαυτὸν	ἐνιαυτός	Case: accusative, Gender: masculine, Number: singular	year
λαμπαδηδρομίαν	λαμπαδηδρομία	Case: accusative, Gender: feminine, Number: singular	the torch-race
1.4.5	1.4.5		
νεανίαι	νεανίης	Case: nominative, Gender: masculine, Number: plural	
ἠγωνίζοντο	ἀγωνίζομαι	Aspect: imperfective, Mood: indicative, Number: plural, Person: third, Tense: past, VerbForm: finite, Voice: middle	to contend for a prize
1.4.6	1.4.6		
Ἕκαστος	Ἕκαστος	Case: nominative, Degree: positive, Gender: masculine, Number: singular	
λαμπάδα	λαμπάς	Case: accusative, Gender: feminine, Number: singular	a torch
ἔφερεν	φερενόω	Aspect: imperfective, Mood: indicative, Number: singular, Person: third, Tense: past, VerbForm: finite, Voice: active	
1.4.7	1.4.7	Case: genitive, Gender: masculine, Number: singular	
Ὡρμῶντο	Ὡρμῶντος	Case: genitive, Gender: masculine, Number: singular	
Κεραμεικοῦ	Κεραμεικός	Case: genitive, Degree: positive, Gender: masculine, Number: singular	the Potters’ Quarter in Athens; (adj.) of Ceramus, in Caria
1.4.8	1.4.8	Case: genitive, Gender: masculine, Number: singular	
Ἔτρεχον	τρέχω	Aspect: imperfective, Mood: indicative, Number: plural, Person: third, Tense: past, VerbForm: finite, Voice: active	to run
ἀκρόπολιν	ἀκρόπολις	Case: accusative, Gender: feminine, Number: singular	the upper city
1.4.9	1.4.9	Case: genitive, Gender: masculine, Number: singular	
αἰθομένην	αἱθέω	Case: accusative, Gender: feminine, Number: singular, Tense: present, VerbForm: participle, Voice: middle	
1.5.0	1.5.0	Case: genitive, Gender: masculine, Number: singular	
Winds	Winds	Case: genitive, Gender: masculine, Number: singular	
1.5.1	1.5.1	Case: nominative, Gender: masculine, Number: singular	
Αἴολος	Αἴολος	Case: nominative, Gender: masculine, Number: singular	Aeolus
ἀνέμων	ἀνέμων	Case: genitive, Gender: masculine, Number: plural	
1.5.2	1.5.2	Case: accusative, Definiteness: definite, Gender: masculine, Number: plural, PrononimalType: demonstrative	
Βορέας	βορέας	Case: accusative, Gender: masculine, Number: plural	
1.5.3	1.5.3	Case: genitive, Gender: masculine, Number: singular	
ἄρκτου	ἄρκτους	Case: genitive, Gender: feminine, Number: singular	
1.5.4	1.5.4	Case: genitive, Gender: feminine, Number: singular	
Νότος	Νότος	Case: nominative, Gender: masculine, Number: singular	the south wind
ὑγρὸς	ὑγρός	Case: nominative, Degree: positive, Gender: masculine, Number: singular	wet, moist, running, fluid
ἐστιν	ἐστινᾶ		
1.5.5	1.5.5	Case: genitive, Gender: masculine, Number: singular	
Ἐκεῖνος	Ἐκεῖνος	Case: nominative, Gender: masculine, Number: singular	
ὄμβρους	ὄμβρος	Case: accusative, Gender: masculine, Number: plural	storm of rain, thunder-storm
1.5.6	1.5.6	Case: accusative, Gender: masculine, Number: singular	
Ζέφυρος	Ζέφυρος	Case: nominative, Gender: masculine, Number: singular	Zephyrus, the west wind
πραότερος	πραός	Case: nominative, Degree: comparative, Gender: masculine, Number: singular	
εὐμενέστερός	εὐμενής	Case: nominative, Degree: comparative, Gender: masculine, Number: singular	well-disposed, kindly
1.5.7	1.5.7	Case: genitive, Gender: masculine, Number: singular	
ἄνεμος	ἄνεμος	Case: nominative, Gender: masculine, Number: singular	wind
αὐδιαιτέραν	αὐδίας	Case: accusative, Degree: comparative, Gender: feminine, Number: singular	
θάλασσαν	θάλασσαν	Case: accusative, Gender: feminine, Number: singular	
1.5.8	ὅ.εις	Case: genitive, Gender: masculine, Number: singular, Person: third, PrononimalType: personal	
Εὖρος	Εὖρος	Case: nominative, Gender: masculine, Number: singular	the East wind
μέλας	μέλας	Case: nominative, Degree: positive, Gender: masculine, Number: singular	black
δυσμενής	δυσμενής	Case: nominative, Degree: positive, Gender: masculine, Number: singular	full of ill-will, hostile
1.5.9	1.5.9	Case: genitive, Gender: masculine, Number: singular	
πνεῦμαι	πνέμω	Mood: indicative, Number: singular, Person: first, Tense: present, VerbForm: finite, Voice: middle	
καίει	καίω	Mood: indicative, Number: singular, Person: third, Tense: present, VerbForm: finite, Voice: active	to light, kindle
γῆν	γῆνος	Case: accusative, Gender: feminine, Number: singular	
1.6.0	1.6.0	Case: genitive, Gender: masculine, Number: singular	
Prometheus	Prometheus	Case: genitive, Degree: positive, Gender: masculine, Number: singular	
Stealing	Stealing	Case: genitive, Degree: positive, Gender: masculine, Number: singular	
Fire	Fire	Case: genitive, Degree: positive, Gender: masculine, Number: singular	
1.6.1	1.6.1	Case: genitive, Gender: masculine, Number: singular	
Προμηθεὺς	Προμηθεύς	Case: nominative, Gender: masculine, Number: singular	Prometheus
Ἰαπετοῦ	Ἰαπετός	Case: genitive, Gender: masculine, Number: singular	
Κλυμένης	Κλυμένης	Case: nominative, Gender: masculine, Number: singular	
1.6.2	1.6.2	Case: nominative, Gender: masculine, Number: singular	
Τέχνας	Τέχναι	Case: accusative, Gender: feminine, Number: plural	
ἐξευρεῖν	ἐξευρίσκω	Aspect: perfective, Tense: past, VerbForm: infinitive, Voice: active	to find out, discover
1.6.3	1.6.3	Case: genitive, Gender: masculine, Number: singular	
1.6.4	1.6.4	Case: dative, Degree: positive, Gender: masculine, Number: plural	
ἀνέβη	ἀναβαίνω	Aspect: perfective, Mood: indicative, Number: singular, Person: third, Tense: past, VerbForm: finite, Voice: active	to go up, mount, to go up to
Ὀλυμπον	Ὀλυμπόν	Case: accusative, Gender: masculine, Number: singular	
οἶκον	οἰκονή	Case: accusative, Gender: masculine, Number: singular	
Ἐντεῦθεν	Ἐντεῦθεν		
ἔκλεψεν	ἔκλλω	Aspect: perfective, Mood: indicative, Number: singular, Person: third, Tense: past, VerbForm: finite, Voice: active	
1.6.6	1.6.6	Case: nominative, Degree: positive, Gender: masculine, Number: singular	
ἀπέκρυψεν	ἀποκρύπτω	Aspect: perfective, Mood: indicative, Number: singular, Person: third, Tense: past, VerbForm: finite, Voice: active	to hide from, keep hidden from
νάρθηκι	νάρθηκις	Case: dative, Gender: feminine, Number: singular	
1.6.7	1.6.7	Case: genitive, Degree: positive, Gender: masculine, Number: singular	
χαλεπῶς	χαλεπῶς	Degree: positive	with difficulty
ἔφερον	φερονέω	Aspect: imperfective, Mood: indicative, Number: plural, Person: third, Tense: past, VerbForm: finite, Voice: active	
1.6.8	1.6.8	Case: accusative, Gender: masculine, Number: singular	
τιμωρεῖσθαι	τιμωρέω	Tense: present, VerbForm: infinitive, Voice: middle	to seek, exact vengeance; help to retaliate
1.6.9	1.6.9	Case: accusative, Gender: masculine, Number: singular	
ὠφελήσας	ὠφελέω	Aspect: perfective, Case: nominative, Gender: masculine, Number: singular, Tense: past, VerbForm: participle, Voice: active	to help, aid, assist, to be of use
ἔπαθεν	παθένχομαι	Aspect: perfective, Mood: indicative, Number: singular, Person: third, Tense: past, VerbForm: finite, Voice: active	
1.7.0	1.7.0	Case: genitive, Gender: masculine, Number: singular	
Hoplite	Hoplite	Case: genitive, Degree: positive, Gender: masculine, Number: singular	
1.7.1	1.7.1	Case: genitive, Gender: masculine, Number: singular	
1.7.2	1.7.2	Case: genitive, Gender: masculine, Number: singular	
ἐπεστράτευον	ἐπεστράτεύω	Aspect: imperfective, Mood: indicative, Number: plural, Person: third, Tense: past, VerbForm: finite, Voice: active	
1.7.3	1.7.3	Case: genitive, Gender: masculine, Number: singular	
Λακεδαιμόνιοι	Λακεδαιμόνιος	Case: nominative, Degree: positive, Gender: masculine, Number: plural	Spartan
κλεινότατοι	κλεινός	Case: nominative, Degree: superlative, Gender: masculine, Number: plural	famous, renowned, illustrious
Ἑλλήνων	Ἑλλήνων	Case: genitive, Gender: masculine, Number: plural	
1.7.4	1.7.4	Case: nominative, Gender: masculine, Number: singular	
Ὁπλίτης	Ὁπλίτης	Case: nominative, Gender: masculine, Number: singular	
πεζῇ	πεζῇ		
1.7.5	1.7.5		
Βαρέα	Βαρύς	Case: accusative, Degree: positive, Gender: neuter, Number: plural	
1.7.6	1.7.6	Case: genitive, Degree: positive, Gender: masculine, Number: singular	
1.7.7	1.7.7	Case: nominative, Degree: positive, Gender: neuter, Number: singular	
ψιλοὶ	ψιλός	Case: nominative, Degree: positive, Gender: masculine, Number: plural	bare, stripped; (soldier) without heavy armor, light troops
ξυνεστρατεύοντο	ξυστρατεύω	Aspect: imperfective, Mood: indicative, Number: plural, Person: third, Tense: past, VerbForm: finite, Voice: middle	
1.7.9	1.7.9	Case: accusative, Gender: masculine, Number: singular	
1.8.0	1.8.0	Case: genitive, Gender: masculine, Number: singular	
Artemis	Artemis	Case: genitive, Degree: positive, Gender: masculine, Number: singular	
1.8.1	1.8.1	Case: genitive, Gender: masculine, Number: singular	
Ἀπόλλωνος	Ἀπόλλων	Case: genitive, Gender: masculine, Number: singular	Apollo
κασίγνητος	κασίγνητος	Case: nominative, Degree: positive, Gender: masculine, Number: singular	a brother; adj of a brother; sibling
1.8.2	1.8.2	Case: genitive, Gender: masculine, Number: singular	
κυναγόν	κυνάγων	Case: accusative, Gender: feminine, Number: singular	
1.8.3	1.8.3	Case: genitive, Gender: masculine, Number: singular	
τόξον	τόξον	Case: accusative, Gender: neuter, Number: singular	a bow
ὀϊστούς	ὀϊστός	Case: accusative, Gender: masculine, Number: plural	arrow
1.8.4	1.8.4	Case: genitive, Gender: masculine, Number: singular	
Ἔμπειρος	Ἔμπειρος	Case: nominative, Degree: positive, Gender: masculine, Number: singular	
1.8.5	1.8.5	Case: genitive, Degree: positive, Gender: masculine, Number: singular	
Ἔκτεινε	κτείνω	Aspect: imperfective, Mood: indicative, Number: singular, Person: third, Tense: past, VerbForm: finite, Voice: active	to kill, slay
βέλεσιν	βέλεσις	Case: dative, Gender: neuter, Number: plural	
θῆρας	θῆρυς	Case: accusative, Gender: masculine, Number: plural	
1.8.6	1.8.6		
Ἐφίλει	φιλέω	Aspect: imperfective, Mood: indicative, Number: singular, Person: third, Tense: past, VerbForm: finite, Voice: active	to love, regard with affection
θηρεύειν	θηρεύω	Tense: present, VerbForm: infinitive, Voice: active	to hunt, go hunting
ἐλάφους	ἔλαφος	Case: accusative, Gender: feminine, Number: plural	a deer
ὄρεσιν	ὄρεσις	Case: dative, Gender: neuter, Number: plural	
Ταχίστη	Ταχίστη	Case: nominative, Gender: feminine, Number: singular	
1.8.8	1.8.8	Case: genitive, Gender: feminine, Number: singular	
ἔγημεν	γαμέω	Aspect: perfective, Mood: indicative, Number: singular, Person: third, Tense: past, VerbForm: finite, Voice: active	to marry
1.8.9	1.8.9	Case: genitive, Gender: feminine, Number: singular	
Ἐφέσῳ	Ἔφεσος	Case: dative, Gender: feminine, Number: singular	Ephesus (f., the city; m., the founder)
1.8.10	1.8.10	Case: nominative, Gender: masculine, Number: singular	
Οἰνεύς	Οἰνεύς	Case: nominative, Gender: masculine, Number: singular	Oeneus
Αἰτωλίας	Αἰτωλία	Case: genitive, Gender: feminine, Number: singular	Aetolia
καθύβρισε	καθυβρίζω	Aspect: perfective, Mood: indicative, Number: singular, Person: third, Tense: past, VerbForm: finite, Voice: active	to treat despitefully, to insult or affront wantonly
Ἀρτέμιδα	Ἀρτέμιδαι	Case: accusative, Gender: feminine, Number: singular	
1.8.11	1.8.11	Case: genitive, Gender: masculine, Number: singular	
ἐζημίωσεν	ζημιόω	Aspect: perfective, Mood: indicative, Number: singular, Person: third, Tense: past, VerbForm: finite, Voice: active	cause a loss, penalize; fine; punish
ὕβρεως	ὕβρευς	Case: genitive, Gender: feminine, Number: singular	
1.8.12	1.8.12	Case: genitive, Gender: masculine, Number: singular, Person: third, PrononimalType: personal	
κάπρον	κάπρος	Case: accusative, Gender: masculine, Number: singular	the boar, wild boar
1.8.13	1.8.13	Case: genitive, Gender: masculine, Number: singular	
Μελέαγρος	Μελέαγρος	Case: nominative, Gender: masculine, Number: singular	
ξυλλέξας	ξυλλέω	Aspect: perfective, Case: nominative, Gender: masculine, Number: singular, Tense: past, VerbForm: participle, Voice: active	
θῆρα	θῆρα	Case: accusative, Gender: masculine, Number: singular	
δόρατι	δόρυτις	Case: dative, Gender: neuter, Number: singular	
1.8.14	1.8.14	Case: genitive, Gender: masculine, Number: singular	
ἀποκόψας	ἀποκόπτω	Aspect: perfective, Case: nominative, Gender: masculine, Number: singular, Tense: past, VerbForm: participle, Voice: active	to cut off, hew off
Ἀταλάντῃ	Ἀταλάντης	Case: dative, Gender: masculine, Number: singular	
1.8.15	1.8.15	Case: dative, Gender: masculine, Number: singular	
δέρμα	δέρμα	Case: nominative, Gender: neuter, Number: singular	the skin, hide
καθιέρωσε	καθιερόω	Aspect: perfective, Mood: indicative, Number: singular, Person: third, Tense: past, VerbForm: finite, Voice: active	to dedicate, devote, hallow
1.8.16	1.8.16	Case: genitive, Gender: masculine, Number: singular	
Μελέαγρον	Μελέαγρον	Case: accusative, Gender: masculine, Number: singular	
1.8.17	1.8.17	Case: genitive, Gender: masculine, Number: singular	
1.8.18	1.8.18	Case: genitive, Gender: masculine, Number: singular	
Οὕτω	οὕτω(ς)		
τιμωρίαν	τιμωρία	Case: accusative, Gender: feminine, Number: singular	retribution, vengeance
1.9.0	1.9.0	Case: genitive, Gender: masculine, Number: singular	
Athletes	Athletes	Case: genitive, Degree: positive, Gender: masculine, Number: singular	
1.9.1	1.9.1	Case: genitive, Gender: masculine, Number: singular	
Ἑλλὰς	Ἑλλάς	Case: nominative, Gender: feminine, Number: singular	Hellas
ἀξιολόγους	ἀξιόλογος	Case: accusative, Degree: positive, Gender: masculine, Number: plural	worthy of mention, noteworthy
1.9.2	1.9.2	Case: accusative, Gender: masculine, Number: singular	
ἀξιόχρεῳ	ἀξιόχρεως	Case: dative, Degree: positive, Gender: masculine, Number: singular	worthy of a thing
1.9.3	1.9.3	Case: dative, Gender: masculine, Number: singular	
Ἐγύμναζον	γυμνάζω	Aspect: imperfective, Mood: indicative, Number: plural, Person: third, Tense: past, VerbForm: finite, Voice: active	to train naked, train in gymnastic exercise
1.9.4	1.9.4	Case: accusative, Gender: masculine, Number: singular	
Ὀλυμπιακὸς	Ὀλυμπιακός	Case: nominative, Gender: masculine, Number: singular	Olympian
εὐδοξότατος	εὐδοξότατος	Case: nominative, Degree: superlative, Gender: masculine, Number: singular	
ἦν	ἦν		
1.9.5	1.9.5	Case: genitive, Gender: masculine, Number: singular	
σφόδρα	σφόδρα		very, very much, exceedingly, violently
ἔπειροι	ἔπειρος	Case: nominative, Degree: positive, Gender: masculine, Number: plural	
δίσκον	δίσκος	Case: accusative, Degree: positive, Gender: masculine, Number: singular	discus, quoit , of metal or stone
βάλλειν	βαλλείνω	Tense: present, VerbForm: infinitive, Voice: active	
1.9.6	1.9.6	Case: accusative, Gender: masculine, Number: singular	
δρόμῳ	δρόμος	Case: dative, Gender: masculine, Number: singular	a course, running, race
1.9.7	1.9.7	Case: genitive, Gender: masculine, Number: singular	
νικητήριον	νικητήριον	Case: nominative, Gender: neuter, Number: singular	
στέφανος	στέφανος	Case: nominative, Gender: masculine, Number: singular	wreath, crown
κοτίνου	κότινος	Case: genitive, Degree: positive, Gender: masculine, Number: singular	the wild olive-tree
1.9.8	1.9.8	Case: genitive, Gender: masculine, Number: singular	
ἆθλον	ἔθλον	Case: accusative, Gender: neuter, Number: singular	
1.9.9	δι.άω	Tense: present, VerbForm: infinitive, Voice: active	
Πίνδαρος	Πίνδαρος	Case: nominative, Gender: masculine, Number: singular	Pindar
ἄθλων	ἄθλων	Case: genitive, Degree: positive, Gender: masculine, Number: plural	
1.10.0	1.10.0	Case: genitive, Gender: masculine, Number: singular	
Darius	Darius	Case: genitive, Degree: positive, Gender: masculine, Number: singular	
1.10.1	1.10.1	Case: genitive, Gender: masculine, Number: singular	
Δαρεῖος	Δαρεῖος	Case: nominative, Gender: masculine, Number: singular	Darius
Περσῶν	Πέρσης	Case: genitive, Gender: masculine, Number: plural	a Persian; Perses (pr.n.)
ἦν	ἄνος	Case: genitive, Definiteness: definite, Gender: masculine, Number: singular, PrononimalType: demonstrative	
1.10.2	1.10.2	Case: genitive, Gender: masculine, Number: singular	
Σοφώτερος	Σοφώτηρ	Case: nominative, Gender: masculine, Number: singular	
πρόσθεν	πρόσθεν		before
ἀρχόντων	ἀρχόντων	Case: genitive, Gender: masculine, Number: plural	
1.10.3	1.10.3	Case: genitive, Gender: masculine, Number: singular	
Φόρον	Φόρος	Case: accusative, Gender: masculine, Number: singular	
ὑπηκόοις	ὑπήκοος	Case: dative, Degree: positive, Gender: masculine, Number: plural	giving ear, listening to
1.10.4	1.10.4	Case: genitive, Gender: masculine, Number: singular	
Κιλίκιοι	Κιλίκιος	Case: nominative, Degree: positive, Gender: masculine, Number: plural	Cilician, of Cilicia
φόρον	φόρος	Case: accusative, Gender: masculine, Number: singular	tribute, payment
λευκῶν	λευκός	Case: genitive, Degree: positive, Gender: masculine, Number: plural	light, bright, clear
ἵππων	ἵππων	Case: genitive, Gender: masculine, Number: plural	
1.10.5	1.10.5	Case: genitive, Degree: positive, Gender: masculine, Number: singular	
Ἰνδῶν	Ἰνδοί	Case: genitive, Gender: masculine, Number: plural	
προσῄει	προσίημι	Aspect: imperfective, Mood: indicative, Number: singular, Person: third, Tense: past, VerbForm: finite, Voice: active	let come to; (mid.) admit, accept
φόρος	φόρυς	Case: nominative, Gender: masculine, Number: singular	
1.10.6	1.10.6	Case: genitive, Degree: positive, Gender: masculine, Number: singular	
ἔπεμψεν	ἔπομπ	Aspect: perfective, Mood: indicative, Number: singular, Person: third, Tense: past, VerbForm: finite, Voice: active	
1.10.7	1.10.7	Case: genitive, Gender: masculine, Number: singular	
Μαραθῶνι	Μαραθώνι	Case: dative, Gender: masculine, Number: singular	
1.10.8	1.10.8	Case: genitive, Gender: masculine, Number: singular	
1.10.9	1.10.9	Case: genitive, Gender: masculine, Number: singular	
ἀνδρειότεροι	ἀνδρεῖος	Case: nominative, Degree: comparative, Gender: masculine, Number: plural	of or for a man; courageous
Περσων	Περσωνᾶς	Case: genitive, Gender: masculine, Number: plural	
1.11.0	1.11.0	Case: genitive, Gender: masculine, Number: singular	
Chariot-races	Chariot-races	Case: nominative, Degree: positive, Gender: masculine, Number: singular	
1.11.1	1.11.1	Case: genitive, Gender: masculine, Number: singular	
ἁρμάτων	ἁρμάτων	Case: genitive, Gender: neuter, Number: plural	
1.11.2	1.11.2	Case: genitive, Degree: positive, Gender: masculine, Number: singular	
Ταχεῖς	Ταχέες	Case: nominative, Gender: masculine, Number: plural	
εἷλκον	ἕλκω	Aspect: imperfective, Mood: indicative, Number: plural, Person: third, Tense: past, VerbForm: finite, Voice: active	to draw, drag
ἅρματα	ἅρμα	Case: accusative, Gender: neuter, Number: plural	a chariot
1.11.3	1.11.3	Case: genitive, Gender: masculine, Number: singular	
εἶχεν	οἶχα	Aspect: imperfective, Mood: indicative, Number: singular, Person: third, Tense: past, VerbForm: finite, Voice: active	
1.11.4	1.11.4	Case: genitive, Gender: masculine, Number: singular	
ἐγίγνοντο	ἐγιγίγνομαι	Aspect: imperfective, Mood: indicative, Number: plural, Person: third, Tense: past, VerbForm: finite, Voice: middle	
1.11.5	1.11.5	Case: genitive, Gender: masculine, Number: singular	
ἆθλον	ἄθλος	Case: nominative, Gender: neuter, Number: singular	
1.11.6	1.11.6	Case: genitive, Gender: masculine, Number: singular	
ἀθάνατον	ἀθάνατος	Case: nominative, Degree: positive, Gender: neuter, Number: singular	undying, immortal
κλέος	κλέος	Case: nominative, Gender: neuter, Number: singular	a rumour, report; fame, glory
ἥδιστον	ἥδιστος	Case: nominative, Degree: superlative, Gender: neuter, Number: singular	
ἐνομίζετο	ἐνομίζω	Aspect: imperfective, Mood: indicative, Number: singular, Person: third, Tense: past, VerbForm: finite, Voice: middle	
1.11.7	1.11.7	Case: genitive, Degree: positive, Gender: masculine, Number: singular	
Ἕλλησιν	Ἕλλησις	Case: dative, Gender: masculine, Number: plural	
1.11.8	1.11.8	Case: genitive, Gender: masculine, Number: singular	
ἡνίοχον	ἡνίοχος	Case: accusative, Gender: masculine, Number: singular	one who holds the reins, a driver, charioteer
φρονιμώτατον	φρόνιμος	Case: accusative, Degree: superlative, Gender: masculine, Number: singular	in one's right mind, in one's senses
1.11.9	1.11.9	Case: genitive, Gender: masculine, Number: singular	
πίονες	πίόν	Case: nominative, Gender: masculine, Number: plural	
οὔποτε	οὔποτε		never
1.12.1	1.12.1	Case: genitive, Gender: masculine, Number: singular	
Chariot	Chariot	Case: genitive, Gender: masculine, Number: singular	
the	the	Case: accusative, Gender: feminine, Number: singular	
Ἥλιος	Ἥλιος	Case: nominative, Gender: masculine, Number: singular	
παλαιοῖς	παλαιος	Case: dative, Degree: positive, Gender: masculine, Number: plural	
1.12.2	1.12.2	Case: genitive, Gender: masculine, Number: singular	
ἐπεστάτει	ἐφίστημι	Mood: indicative, Number: singular, Person: third, Tense: past, VerbForm: finite, Voice: active	to set on, over; set in charge of
μαντεία	μαντεία	Case: dative, Gender: feminine, Number: singular	prophesying, prophetic power
μουσικῇ	μουσικός	Case: dative, Degree: positive, Gender: feminine, Number: singular	 musical, skilled in music, elegant
1.12.3	1.12.3	Case: genitive, Gender: feminine, Number: singular	
Ὁμήρου	Ὁμῆρος	Case: genitive, Gender: masculine, Number: singular	
ἕπεσιν	ἕπεσις	Case: dative, Gender: neuter, Number: plural	
1.12.4	1.12.4	Case: genitive, Gender: masculine, Number: singular	
1.12.5	1.12.5	Case: genitive, Degree: positive, Gender: masculine, Number: singular	
οὐρανοῦ	οὐρανοῦς	Case: genitive, Gender: masculine, Number: singular	
1.12.6	1.12.6	Case: genitive, Gender: masculine, Number: singular	
Τέσσαρες	Τέσσαρες	Case: nominative, Gender: masculine, Number: plural	
ἐζεύχθησαν	ζεύγνυμι	Aspect: perfective, Mood: indicative, Number: plural, Person: third, Tense: past, VerbForm: finite, Voice: passive	to yoke, put to
ἅρματι	ἅρματις	Case: dative, Gender: neuter, Number: singular	
1.12.7	1.12.7	Case: genitive, Gender: masculine, Number: singular	
Φαέθων	Φαέθων	Case: genitive, Gender: masculine, Number: singular	Phaethon
ποτέ	ποτύς	Case: nominative, Gender: masculine, Number: singular, PrononimalType: relative	
Ἡλιόυ	Ἡλιός	Case: genitive, Gender: masculine, Number: singular	
ἤλαυνεν	ἀλαυνέω	Aspect: imperfective, Mood: indicative, Number: singular, Person: third, Tense: past, VerbForm: finite, Voice: active	
1.12.8	1.12.8	Case: genitive, Gender: masculine, Number: singular	
Ἀλλ	ἀλλ		
ἀποδραμόντες	ἀποτρέχω	Aspect: perfective, Case: nominative, Gender: masculine, Number: plural, Tense: past, VerbForm: participle, Voice: active	to run off
ξυνέκαυσαν	ξυγαυσάνω	Aspect: perfective, Mood: indicative, Number: plural, Person: third, Tense: past, VerbForm: finite, Voice: active	
1.12.9	1.12.9	Case: genitive, Gender: masculine, Number: singular	
ὀργισθεὶς	ὀργίζω	Aspect: perfective, Case: nominative, Gender: masculine, Number: singular, Tense: past, VerbForm: participle, Voice: passive	to make angry, provoke to anger, irritate
κεραυνῷ	κεραυνός	Case: dative, Degree: positive, Gender: masculine, Number: singular	a thunderbolt
1.13.0	1.13.0	Case: genitive, Gender: masculine, Number: singular	
Dirce	Dirce	Case: genitive, Degree: positive, Gender: feminine, Number: singular	
and	and	Case: accusative, Gender: feminine, Number: singular	
Bull	Bull	Case: genitive, Gender: masculine, Number: singular	
1.13.1	1.13.1	Case: genitive, Gender: masculine, Number: singular	
Λύκος	Λύκος	Case: nominative, Gender: masculine, Number: singular	Lycus
Θηβῶν	Θηβᾶς	Case: genitive, Gender: feminine, Number: plural	
Βοιωτίᾳ	Βοιωτία	Case: dative, Gender: feminine, Number: singular	Boeotia
1.13.2	1.13.2	Case: genitive, Gender: masculine, Number: singular	
Ἀντιόπη	Ἀντιόπη	Case: nominative, Gender: feminine, Number: singular	Antiope
Λύκου	Λύκου	Case: genitive, Gender: masculine, Number: singular	
1.13.3	1.13.3	Case: genitive, Gender: masculine, Number: singular	
ἀποπέμψας	ἀποπέμπω	Aspect: perfective, Case: nominative, Gender: masculine, Number: singular, Tense: past, VerbForm: participle, Voice: active	to send off
Ἀντιόπην	Ἀντιόπην	Case: accusative, Gender: feminine, Number: singular	
Δίρκην	Δίρκη	Case: accusative, Gender: masculine, Number: singular	Dirce
1.13.4	1.13.4	Case: genitive, Gender: masculine, Number: singular	
Ἀμφίων	Ἀμφίων	Case: nominative, Gender: masculine, Number: singular	Amphion
Ζῆθος	Ζῆθος	Case: nominative, Gender: masculine, Number: singular	Zethus
υἱεῖς	υἱύς	Case: nominative, Gender: masculine, Number: plural	
Ἀντιόπης	Ἀντιόπης	Case: genitive, Gender: feminine, Number: singular	
1.13.5	1.13.5	Case: genitive, Gender: masculine, Number: singular	
Ἐτράφησαν	τρέσσω	Aspect: perfective, Mood: indicative, Number: plural, Person: third, Tense: past, VerbForm: finite, Voice: passive	
ἥβης	ἥβη	Case: genitive, Gender: feminine, Number: singular	manhood, youthful prime, youth
Κιθαιρῶνι	Κιθαιρῶνις	Case: dative, Gender: masculine, Number: singular	
1.13.6	1.13.6	Case: genitive, Gender: masculine, Number: singular	
Μαθόντες	Μαθόντος	Case: nominative, Gender: masculine, Number: plural	
πεφύκασιν	φυκάζω	Aspect: perfective, Mood: indicative, Number: plural, Person: third, Tense: past, VerbForm: finite, Voice: active	
1.13.7	1.13.7	Case: genitive, Gender: masculine, Number: singular	
Ἐπορεύθησαν	πορεύομαι	Aspect: perfective, Mood: indicative, Number: plural, Person: third, Tense: past, VerbForm: finite, Voice: passive	
τάχιστα	ταχέως	Degree: superlative	
Θήβας	Θῆβαι	Case: accusative, Gender: feminine, Number: plural	Thebes (usu. plural)
1.13.8	1.13.8	Case: genitive, Gender: masculine, Number: singular	
Προσβολὴν	Προσβολή	Case: accusative, Gender: feminine, Number: singular	
1.13.9	1.13.9	Case: genitive, Gender: masculine, Number: singular	
1.13.10	1.13.10	Case: genitive, Gender: masculine, Number: singular	
ταύρου	ταῦρος	Case: genitive, Gender: masculine, Number: singular	a bull
βίᾳ	βία	Case: dative, Gender: feminine, Number: singular	bodily strength, force, power, might
ἐκρᾶτησαν	κρᾶτω	Aspect: perfective, Mood: indicative, Number: plural, Person: third, Tense: past, VerbForm: finite, Voice: active	
1.13.11	1.13.11	Case: genitive, Degree: positive, Gender: masculine, Number: singular	
1.13.12	1.13.12	Case: genitive, Gender: masculine, Number: singular	
προσῆψαν	προσήπτω	Aspect: perfective, Mood: indicative, Number: plural, Person: third, Tense: past, VerbForm: finite, Voice: active	
σπάρτῳ	σπάρτον	Case: dative, Gender: neuter, Number: singular	a rope, cable
1.13.13	1.13.13	Case: genitive, Degree: positive, Gender: masculine, Number: singular	
παρείλκυσεν	παρειλκύω	Aspect: perfective, Mood: indicative, Number: singular, Person: third, Tense: past, VerbForm: finite, Voice: active	
1.13.14	1.13.14	Case: genitive, Gender: masculine, Number: singular	
Ἄλλους	ἅλλος	Case: accusative, Gender: masculine, Number: plural	
1.13.15	1.13.15	Case: genitive, Gender: masculine, Number: singular	
κρήνην	κρήνη	Case: accusative, Gender: feminine, Number: singular	a well, spring, fountain
κατέβαλον	καταβάλλω	Aspect: perfective, Mood: indicative, Number: plural, Person: third, Tense: past, VerbForm: finite, Voice: active	to throw down, overthrow
1.13.16	1.13.16	Case: genitive, Degree: positive, Gender: masculine, Number: singular	
Διρκαιά	Διρκαῖος	Case: nominative, Degree: positive, Gender: feminine, Number: singular	of Dirke, Dircaean
ἐπωνομάσθη	πωνομάζω	Aspect: perfective, Mood: indicative, Number: singular, Person: third, Tense: past, VerbForm: finite, Voice: passive	
1.14.0	1.14.0	Case: genitive, Gender: masculine, Number: singular	
Niobe	Niος	Case: genitive, Degree: positive, Gender: masculine, Number: singular	
1.14.1	1.14.1	Case: genitive, Gender: masculine, Number: singular	
Λύκον	Λύκονα	Case: accusative, Gender: masculine, Number: singular	
Θηβῶν	Θηβῶν	Case: genitive, Gender: feminine, Number: plural	
1.14.2	1.14.2	Case: genitive, Gender: masculine, Number: singular	
Ἑρμῆς	Ἑρμῆς	Case: nominative, Gender: masculine, Number: singular	Hermes; a statue or bust of Hermes
λύραν	λύρα	Case: accusative, Gender: feminine, Number: singular	lyre
Ἀμφίονι	Ἀμφίονις	Case: dative, Gender: masculine, Number: singular	
1.14.3	1.14.3	Case: genitive, Gender: masculine, Number: singular	
1.14.4	1.14.4	Case: genitive, Gender: masculine, Number: singular	
αὐτοὶ	αὐτοὶ		
καθήκοντα	καθήκω	Case: accusative, Gender: masculine, Number: singular, Tense: present, VerbForm: participle, Voice: active	to have come; to suit, to belong to, be one’s duty
τόπον	τόπον	Case: accusative, Gender: masculine, Number: singular	
1.14.5	1.14.5	Case: genitive, Gender: masculine, Number: singular	
Νιόβην	Νιόβη	Case: accusative, Gender: masculine, Number: singular	Niobe
Ταντάλου	Τάνταλος	Case: genitive, Gender: masculine, Number: singular	Tantalus
1.14.6	1.14.6	Case: genitive, Degree: positive, Gender: masculine, Number: singular	
Πολλοὺς	Πολλός	Case: accusative, Degree: positive, Gender: masculine, Number: plural	
θυγατέρας	θυγατέρα	Case: accusative, Gender: feminine, Number: plural	
1.14.7	1.14.7	Case: genitive, Degree: positive, Gender: masculine, Number: singular	
λίαν	λίαν		very, exceedingly
ἐσεμνύνετο	σεμνύνω	Aspect: imperfective, Mood: indicative, Number: singular, Person: third, Tense: past, VerbForm: finite, Voice: middle	to exalt, magnify
1.14.8	1.14.8	Case: genitive, Gender: masculine, Number: singular	
Λητοῖ	Λητός	Case: nominative, Gender: masculine, Number: plural	
τέκνα	τέκνη	Case: nominative, Gender: neuter, Number: plural	
1.14.9	1.14.9	Case: genitive, Degree: positive, Gender: masculine, Number: singular	
Λητὼ	Λήτω	Case: nominative, Gender: feminine, Number: singular	
Ἀρτέμιδος	Ἀρτέμιδος	Case: genitive, Gender: feminine, Number: singular	
1.14.10	1.14.10	Case: genitive, Gender: feminine, Number: singular	
ἀμφότεροι	ἀμφότεροι	Case: nominative, Degree: positive, Gender: masculine, Number: plural	
1.14.11	1.14.11	Case: genitive, Degree: positive, Gender: masculine, Number: singular	
μεγαλαυχουμένη	μεγαλαυχάνω	Case: nominative, Gender: feminine, Number: singular, Tense: present, VerbForm: participle, Voice: middle	
ἐκείνης	ἐκείνος	Case: genitive, Gender: feminine, Number: singular	
1.14.12	1.14.12	Case: genitive, Gender: feminine, Number: singular	
1.14.13	1.14.13	Case: genitive, Gender: feminine, Number: singular	
1.14.14	1.14.14	Case: genitive, Degree: positive, Gender: neuter, Number: singular	
πέτραν	πέτρα	Case: accusative, Gender: feminine, Number: singular	a rock, a ledge
μετέβαλεν	μεταβαίνω	Aspect: perfective, Mood: indicative, Number: singular, Person: third, Tense: past, VerbForm: finite, Voice: active	to pass over from one place to another
1.14.15	1.14.15	Case: genitive, Degree: positive, Gender: masculine, Number: singular	
Πηγαὶ	πηγαί	Case: nominative, Number: plural	
ἀπορρέουσι	ἀπορρέω	Mood: indicative, Number: plural, Person: third, Tense: present, VerbForm: finite, Voice: active	to flow
θέρους	θέρος	Case: genitive, Gender: neuter, Number: singular	summer, summertime; harvest, crop
1.14.16	1.14.16	Case: genitive, Degree: positive, Gender: masculine, Number: singular	
ὑφ	ὗς	Case: accusative, Gender: masculine, Number: singular	wild swine
αὑτοῦ	αὑτός	Case: genitive, Gender: masculine, Number: singular, Person: third, PrononimalType: personal, Reflexive: pos	the same (crasis of ὁ αὐτός)
1.15.0	1.15.0	Case: genitive, Gender: masculine, Number: singular	
Garments	Garments	Case: genitive, Degree: positive, Gender: masculine, Number: singular	
1.15.1	1.15.1	Case: genitive, Gender: masculine, Number: singular	
Ῥωμαῖοι	Ῥωμαῖος	Case: nominative, Degree: positive, Gender: masculine, Number: plural	a Roman
Ελληνες	Ελλην	Case: nominative, Gender: masculine, Number: plural	
ἐφόρουν	φορέω	Aspect: imperfective, Mood: indicative, Number: plural, Person: third, Tense: past, VerbForm: finite, Voice: active	to bear
ἐσθῆτα	ἐσθής	Case: accusative, Gender: feminine, Number: singular	dress, clothing, raiment
1.15.2	1.15.2	Case: genitive, Gender: feminine, Number: singular	
1.15.3	1.15.3	Case: genitive, Degree: positive, Gender: masculine, Number: singular	
χιτῶνα	χιτών	Case: accusative, Gender: masculine, Number: singular	the garment worn next the skin, a frock
1.15.4	1.15.4	Case: genitive, Gender: masculine, Number: singular	
χλαμὺς	χλαμύς	Case: nominative, Gender: feminine, Number: singular	a short mantle
ἱμάτιον	ἱμάτιον	Case: nominative, Gender: neuter, Number: singular	an outer garment, a cloak
1.15.5	1.15.5	Case: genitive, Degree: positive, Gender: masculine, Number: singular	
1.15.6	1.15.6	Case: genitive, Gender: masculine, Number: singular	
μορφῇ	μορφή	Case: dative, Gender: feminine, Number: singular	form, shape
1.15.7	1.15.7	Case: genitive, Gender: masculine, Number: singular	
ἐνεδύοντο	ἐνδύω	Aspect: imperfective, Mood: indicative, Number: plural, Person: third, Tense: past, VerbForm: finite, Voice: middle	to go into
ἐνίοτε	ἐνίοτε		sometimes
σύρμα	σύρμα	Case: accusative, Gender: neuter, Number: singular	anything trailed
1.15.8	1.15.8	Case: genitive, Gender: masculine, Number: singular	
ἔφηβοι	ἔφηβος	Case: nominative, Degree: positive, Gender: masculine, Number: plural	one arrived at puberty
1.15.9	1.15.9	Case: genitive, Gender: masculine, Number: singular	
δῆτα	δῆτα		certainly, to be sure, of course
χαριέστερόν	χαρίεστερος	Case: nominative, Degree: comparative, Gender: neuter, Number: singular	
1.16.0	1.16.0	Case: genitive, Gender: masculine, Number: singular	
Delphi	Delphi	Case: genitive, Degree: positive, Gender: masculine, Number: singular	
1.16.1	1.16.1	Case: genitive, Gender: masculine, Number: singular	
Νεώς	Νεώς	Case: genitive, Gender: masculine, Number: singular	
Δελφοῖς	Δελφοί	Case: dative, Gender: masculine, Number: plural	Delphi; Delphians
1.16.2	1.16.2	Case: genitive, Gender: masculine, Number: singular	
μαντεῖον	μαντεῖον	Case: nominative, Gender: neuter, Number: singular	an oracle
εὐκλεέστατον	εὐκλεής	Case: accusative, Degree: superlative, Gender: neuter, Number: singular	of good report, famous, glorious
1.16.3	1.16.3	Case: genitive, Gender: masculine, Number: singular	
Δυνατοὶ	Δυνατός	Case: nominative, Gender: masculine, Number: plural	
πιστοὺς	πιστός	Case: accusative, Degree: positive, Gender: masculine, Number: plural	liquid (medicines)
ἀγγέλους	ἄγγελος	Case: accusative, Gender: masculine, Number: plural	a messenger, envoy
1.16.4	1.16.4	Case: genitive, Gender: masculine, Number: singular	
ἑκάστοτε	ἑκάστοτε		each time, on each occasion
προσέφερον	προσφέρω	Aspect: imperfective, Mood: indicative, Number: plural, Person: third, Tense: past, VerbForm: finite, Voice: active	to bring to
πολυτελῆ	πολυτελής	Case: accusative, Degree: positive, Gender: neuter, Number: plural	very expensive, very costly
δῶρα	δῶρον	Case: accusative, Gender: neuter, Number: plural	a gift, present
1.16.5	1.16.5	Case: genitive, Degree: positive, Gender: neuter, Number: singular	
πλουσιώτατον	πλουσίωταρος	Case: nominative, Degree: superlative, Gender: neuter, Number: singular	
1.16.6	1.16.6	Case: genitive, Gender: masculine, Number: singular	
χρυσὸς	χρυσός	Case: nominative, Gender: masculine, Number: singular	gold
θησαυροῖς	θησαυρός	Case: dative, Gender: masculine, Number: plural	a store laid up, treasure
1.16.7	1.16.7	Case: genitive, Gender: masculine, Number: singular	
ἱέρεια	ἱέρειον	Case: nominative, Gender: feminine, Number: singular	
ἐκάθιζε	καθίζω	Aspect: imperfective, Mood: indicative, Number: singular, Person: third, Tense: past, VerbForm: finite, Voice: active	to make to sit down, seat
τρίποδα	τρίπους	Case: accusative, Gender: masculine, Number: singular	three-footed, of or with three feet (n. a tripod)
1.16.8	1.16.8	Case: genitive, Degree: positive, Gender: masculine, Number: singular	
Πνεῦμά	Πνεῦμα	Case: nominative, Gender: neuter, Number: singular	
θερμὸν	θερμός	Case: nominative, Degree: positive, Gender: neuter, Number: singular	hot, warm
χάσμα	χάσμα	Case: accusative, Gender: neuter, Number: singular	a yawning hollow, chasm, gulf
ἀναφερόμενον	ἀναφέρω	Case: nominative, Gender: neuter, Number: singular, Tense: present, VerbForm: participle, Voice: passive	to bring up, bring back
ἐπῆρε	ἐπαίρω	Aspect: perfective, Mood: indicative, Number: singular, Person: third, Tense: past, VerbForm: finite, Voice: active	to lift up and set on
ἱέρειαν	ἱέρειαν	Case: accusative, Gender: feminine, Number: singular	
1.16.9	1.16.9	Case: genitive, Gender: masculine, Number: singular	
Βυζαντίῳ	Βυζάντιον	Case: dative, Gender: neuter, Number: singular	Byzantium (no LSJ entry; see Byzantium)
1.17.0	1.17.0	Case: genitive, Gender: masculine, Number: singular	
Theatre	Theatre	Case: genitive, Gender: masculine, Number: singular	
Dionysus	Dionysus	Case: genitive, Gender: masculine, Number: singular	
1.17.1	1.17.1	Case: genitive, Gender: masculine, Number: singular	
θέατρον	θέατρον	Case: nominative, Gender: neuter, Number: singular	a place for seeing
Διονύσου	Διονύσους	Case: genitive, Gender: masculine, Number: singular	
1.17.2	1.17.2	Case: genitive, Gender: masculine, Number: singular	
κοῖλον	κοίλος	Case: nominative, Gender: neuter, Number: singular	
Ἀκροπόλεως	Ἀκρόπολις	Case: genitive, Gender: feminine, Number: singular	
πέτρου	πέτρον	Case: genitive, Gender: neuter, Number: singular	
1.17.3	1.17.3	Case: genitive, Degree: positive, Gender: neuter, Number: singular	
κερκίδες	κερκίς	Case: nominative, Gender: feminine, Number: plural	the rod
ἐσχίσθησαν	σχίζω	Aspect: perfective, Mood: indicative, Number: plural, Person: third, Tense: past, VerbForm: finite, Voice: passive	to split, cleave
πλατείαις	πλατεῖα	Case: dative, Gender: feminine, Number: plural	street
κλίμαξι	κλίμαξις	Case: dative, Gender: neuter, Number: plural	
1.17.4	1.17.4	Case: genitive, Degree: positive, Gender: masculine, Number: singular	
ἕδραι	ἕδρα	Case: nominative, Gender: feminine, Number: plural	a sitting-place
λίθιναί	λίθινος	Case: nominative, Degree: positive, Gender: feminine, Number: plural	of stone
εἰσιν	οἶσι	Mood: indicative, Number: plural, Person: second, Tense: present, VerbForm: finite, Voice: active	
1.17.5	1.17.5	Case: genitive, Gender: masculine, Number: singular	
ἱερεῖς	ἱερεύς	Case: nominative, Gender: masculine, Number: plural	a priest, sacrificer
θρόνους	θρόνους	Case: accusative, Gender: masculine, Number: plural	
1.17.6	1.17.6	Case: genitive, Degree: positive, Gender: masculine, Number: singular	
θρόνοι	θρόνος	Case: nominative, Gender: masculine, Number: plural	a seat, chair
1.17.7	1.17.7	Case: genitive, Gender: masculine, Number: singular	
Εὐριπίδης	Εὐριπίδης	Case: nominative, Gender: masculine, Number: singular	Euripides
ἐνδόξους	ἐνδόξοος	Case: accusative, Degree: positive, Gender: feminine, Number: plural	
1.17.8	1.17.8	Case: genitive, Gender: masculine, Number: singular	
1.17.9	1.17.9	Case: genitive, Gender: masculine, Number: singular	
βωμὸς	βωμός	Case: nominative, Gender: masculine, Number: singular	any raised platform, a stand
ὀρχήστρᾳ	ὀρχήστρα	Case: dative, Gender: feminine, Number: singular	the orchestra
1.18.0	1.18.0	Case: genitive, Gender: masculine, Number: singular	
Musical	Musical	Case: genitive, Degree: positive, Gender: masculine, Number: singular	
Instruments	Instruments	Case: genitive, Degree: positive, Gender: masculine, Number: singular	
1.18.1	1.18.1	Case: genitive, Gender: masculine, Number: singular	
ἔμπειροι	ἔμπειρος	Case: nominative, Degree: positive, Gender: masculine, Number: plural	experienced
1.18.2	1.18.2	Case: genitive, Gender: feminine, Number: singular	
φόρμιγγι	φόρμιγξ	Case: dative, Gender: feminine, Number: singular	the phorminx
ἐχρῶντο	χράω	Aspect: imperfective, Mood: indicative, Number: plural, Person: third, Tense: past, VerbForm: finite, Voice: middle	to fall upon, attack, assail
κιθάρᾳ	κιθάρη	Case: dative, Gender: feminine, Number: singular	
1.18.3	1.18.3	Case: genitive, Gender: masculine, Number: singular	
κιθάραν	κιθάρανος	Case: accusative, Gender: feminine, Number: singular	
λύραν	λύραν	Case: accusative, Gender: feminine, Number: singular	
1.18.4	1.18.4	Mood: indicative, Number: singular, Person: third, Tense: present, VerbForm: finite, Voice: active	
χοροῖς	χορός	Case: dative, Gender: masculine, Number: plural	a round dance
αὐλητής	αὐλητής	Case: nominative, Gender: masculine, Number: singular	an aulos-player
αὐλὸν	αὐλός	Case: accusative, Gender: masculine, Number: singular	aulos (wind instrument resembling oboe)
ἔχων	χωνέω	Case: nominative, Gender: masculine, Number: singular, Tense: present, VerbForm: participle, Voice: active	
1.18.5	1.18.5	Case: genitive, Gender: masculine, Number: singular	
ξύλινοι	ξύλινος	Case: nominative, Degree: positive, Gender: masculine, Number: plural	of wood, wooden
ὀστέϊνοι	ὀστέϊνος	Case: nominative, Degree: positive, Gender: masculine, Number: plural	made of bone, of bone
1.18.6	1.18.6	Case: genitive, Gender: masculine, Number: singular	
χορδὰς	χορδή	Case: accusative, Gender: feminine, Number: plural	gut, gut string, sausage
οὔκ	οὗκε	Case: genitive, Definiteness: definite, Gender: masculine, Number: singular, PrononimalType: demonstrative	
1.18.7	1.18.7	Case: genitive, Gender: masculine, Number: singular	
Φυσᾶται	Φυσάτης	Case: nominative, Gender: masculine, Number: plural	
ψάλλεται	ψάλλω	Mood: indicative, Number: singular, Person: third, Tense: present, VerbForm: finite, Voice: middle	to touch sharply, to pluck, pull, twitch
1.18.8	1.18.8	Case: genitive, Gender: feminine, Number: singular	
ἄρχων	ἄρχων	Case: nominative, Gender: masculine, Number: singular	a ruler, commander, chief, captain
ἀπενεμε	ἀπονέμω	Mood: indicative, Number: singular, Person: third, Tense: past, VerbForm: finite, Voice: active	to portion out, impart, assign
χορηγῷ	χορηγός	Case: dative, Gender: masculine, Number: singular	a chorus leader
1.18.9	1.18.9	Case: genitive, Gender: masculine, Number: singular	
μισθὸν	μισθός	Case: accusative, Gender: masculine, Number: singular	wages, pay, hire
1.19.0	1.19.0	Case: genitive, Gender: masculine, Number: singular	
Ships	Ships	Case: genitive, Gender: masculine, Number: singular	
1.19.1	1.19.1	Case: genitive, Gender: masculine, Number: singular	
ἐρέτας	ἐρέτης	Case: accusative, Gender: feminine, Number: plural	a rower
ναυβάτας	ναυβάται	Case: accusative, Gender: masculine, Number: plural	
1.19.2	1.19.2	Case: genitive, Degree: positive, Gender: masculine, Number: singular	
κώπαις	κώπαις	Case: dative, Gender: feminine, Number: plural	
1.19.3	1.19.3	Case: genitive, Degree: positive, Gender: masculine, Number: singular	
πρῷρα	πρῷρα	Case: nominative, Gender: feminine, Number: singular	the forepart of a ship, a ship's head, prow, bow
ὑψηλὴ	ὑψηλής	Case: nominative, Degree: positive, Gender: feminine, Number: singular	
1.19.4	1.19.4	Case: genitive, Gender: masculine, Number: singular	
Πρότονοι	Πρότονος	Case: nominative, Gender: masculine, Number: plural	
ἐστήριξαν	στηρίζω	Aspect: perfective, Mood: indicative, Number: plural, Person: third, Tense: past, VerbForm: finite, Voice: active	to make fast, prop, fix, set
ἱστόν	ἱστόν	Case: accusative, Gender: masculine, Number: singular	
1.19.5	1.19.5	Case: genitive, Gender: masculine, Number: singular	
ναῦται	ναύτης	Case: nominative, Gender: masculine, Number: plural	a sailor, seaman; a fellow sailor
ἦραν	ἀείρω	Aspect: perfective, Mood: indicative, Number: plural, Person: third, Tense: past, VerbForm: finite, Voice: active	to lift, heave, raise up
1.19.6	1.19.6	Case: genitive, Gender: masculine, Number: singular	
ἐνέπλησε	ἐμπίμπλημι	Aspect: perfective, Mood: indicative, Number: singular, Person: third, Tense: past, VerbForm: finite, Voice: active	fill quite full
ἱστία	ἱστία	Case: nominative, Gender: neuter, Number: plural	feast
1.19.7	1.19.7	Case: genitive, Gender: masculine, Number: singular	
Κορίνθιοι	Κορίνθιος	Case: nominative, Degree: positive, Gender: masculine, Number: plural	Corinthian
τριήρεις	τριήρης	Case: accusative, Gender: feminine, Number: plural	trireme
ἐναυπήγησαν	ἐναυπάω	Aspect: perfective, Mood: indicative, Number: plural, Person: third, Tense: past, VerbForm: finite, Voice: active	
1.19.8	1.19.8	Case: genitive, Gender: masculine, Number: singular	
ἱστίοις	ἑστίον	Case: dative, Gender: masculine, Number: plural	
κώπαις	κώπα	Case: dative, Gender: feminine, Number: plural	oar
ἐχρῶντο	ἐχρῴω	Aspect: imperfective, Mood: indicative, Number: plural, Person: third, Tense: past, VerbForm: finite, Voice: middle	
1.19.9	1.19.9	Case: genitive, Gender: masculine, Number: singular	
ἔμβολος	ἔμβολος	Case: nominative, Gender: masculine, Number: singular	pointed so as to be thrust in: ram, peg, bolt
ἔρρηξε	ῥήγνυμι	Aspect: perfective, Mood: indicative, Number: singular, Person: third, Tense: past, VerbForm: finite, Voice: active	to break, break asunder
1.20.0	1.20.0	Case: genitive, Gender: masculine, Number: singular	
Paris	Paris	Case: genitive, Degree: positive, Gender: masculine, Number: singular	
1.20.1	1.20.1	Case: genitive, Gender: masculine, Number: singular	
Πάρις	Πάρις	Case: nominative, Gender: masculine, Number: singular	Paris son of Priam
Πριάμου	Πρίαμος	Case: genitive, Gender: masculine, Number: singular	Priam
Τροίας	Τροία	Case: genitive, Gender: feminine, Number: singular	Troy
1.20.2	1.20.2	Case: genitive, Gender: masculine, Number: singular	
Λακεδαίμονα	Λακεδαίμων	Case: accusative, Gender: feminine, Number: singular	Lacedaemon
Ἑλένην	Ἑλένη	Case: accusative, Gender: feminine, Number: singular	Helen
Μενέλεω	Μενέλαος	Case: genitive, Gender: masculine, Number: singular	Menelaos
1.20.3	1.20.3	Case: genitive, Degree: positive, Gender: masculine, Number: singular	
ἀπελθόντος	ἀπέρχομαι	Aspect: perfective, Case: genitive, Gender: masculine, Number: singular, Tense: past, VerbForm: participle, Voice: active	to go away, depart from
Κρήτην	Κρήτη	Case: accusative, Gender: feminine, Number: singular	Crete
ἀπεκόμισε	ἀποκομίζω	Aspect: perfective, Mood: indicative, Number: singular, Person: third, Tense: past, VerbForm: finite, Voice: active	to carry away, escort
Ἑλένην	Ἑλένην	Case: accusative, Gender: feminine, Number: singular	
1.20.4	1.20.4	Case: genitive, Gender: masculine, Number: singular	
Ἔλληνες	Ἔλλην	Case: nominative, Gender: masculine, Number: plural	
ἠγανάκτησαν	ἀγανακτέω	Aspect: perfective, Mood: indicative, Number: plural, Person: third, Tense: past, VerbForm: finite, Voice: active	to feel irritation
1.20.5	1.20.5	Case: genitive, Gender: masculine, Number: singular	
ἐπῆλθον	ἐπέρχομαι	Aspect: perfective, Mood: indicative, Number: plural, Person: third, Tense: past, VerbForm: finite, Voice: active	come near; come upon; attack
Τρῶσιν	Τρῶσις	Case: dative, Gender: masculine, Number: plural	
1.20.6	1.20.6	Case: genitive, Gender: masculine, Number: singular	
1.20.7	1.20.7	Case: genitive, Gender: masculine, Number: singular	
πολιορκήσαντες	πολιορκέω	Aspect: perfective, Case: nominative, Gender: masculine, Number: plural, Tense: past, VerbForm: participle, Voice: active	to hem in a city, blockade, beleaguer, besiege
1.20.8	1.20.8	Case: genitive, Gender: masculine, Number: singular	
τραυματισθεὶς	τραυματίζω	Aspect: perfective, Case: nominative, Gender: masculine, Number: singular, Tense: past, VerbForm: participle, Voice: passive	to wound
